border_size=1
usage=map

Gd          , Gd          , Gd          , Gg          , Gg          , Re          , Re          , Re          , Gg          , Gg          , Gg          , Gg          , Gs          , Gs          , Gs^Fp       , Gg          , Gs^Fp       , Gs^Fp       , Gs^Fp       , Gs^Fp       , Gs^Fp       , Gs^Fp       , Gs^Fp       , Gs^Fp       , Gs^Fp       , Gs^Fp       , Gs^Fp       , Gs^Fp       , Gs^Fp       , Gs^Fp       , Gs^Fp       , Gs^Fp       , Gs^Fp       , Gs^Fp       , Gs          , Gs          , Gs          , Gg          , Gg          , Ww          , Ww          , Ww          , Gg          , Gg          , Gg          , Gg          
Gd          , Gd          , Gd          , Gg          , Ch          , Re          , Re          , Re          , Ch          , Gg          , Gg          , Gg          , Gs          , Gs^Fp       , Gs^Fp       , Gs^Fp       , Gs^Fp       , Gs^Fp       , Gs^Fp       , Gs^Fp       , Gs^Fp       , Gs^Fp       , Gs^Fp       , Gs^Fp       , Gs^Fds      , Gs^Fp       , 3 Gs^Fp     , Gs^Fp       , Gs^Fp       , Gs^Fp       , Gs^Fp       , Gs^Fp       , Gs^Fp       , Gs^Fp       , Gs^Fp       , Gs          , Gs          , Gg          , Ds          , Ww          , Ww          , Ww          , Gg          , Gg          , Gg          , Gg          
Gd          , Gd          , Gg          , Gg          , Gg          , Re          , Re          , Re          , Gg          , Gg          , Gg          , Gg          , Gs          , Gs^Fp       , Gs^Fp       , Gs^Fp       , Gs^Fp       , Gs^Fp       , Gs^Fp       , Gs^Fp       , Gs^Fp       , Gs^Fds      , Gs^Fp       , Gs^Fp       , Gs^Fp       , Gs^Fp       , Gs^Fp       , Gs^Fp       , Gs          , Gs^Fp       , Gs          , Gs          , Gs^Fp       , Gs^Fp       , Gs^Fp       , Gs^Fp       , Gs^Fp       , Gs          , Ds          , Ww          , Ww          , Ww          , Re^Gvs      , Gg          , Gg          , Gg          
Gg          , Gg          , Gll         , Gg          , Gg          , Re          , Re          , Re          , Gg          , Gg          , Gg          , Gg          , Gg          , Gs          , Gs          , Gs^Fp       , Gs          , Gs^Fp       , Gs^Fp       , Gs^Fp       , Gs^Fp       , Gs^Fp       , Gs^Fp       , Gs^Fp       , Gs^Fp       , Gs^Fp       , Gs^Fp       , Gs          , Gg          , Gs          , Gg          , Gs          , Re^Gvs      , Gs^Fp       , Gs^Fp       , Gs^Fp       , Gs^Fp       , Gs          , Ds          , Ww          , Ww          , Re^Gvs      , Re^Gvs      , Re^Gvs      , Gg          , Gg          
Gll         , Gll         , Gll         , Gg          , Re          , Re          , Re          , Re          , Gg          , Gg          , Gg          , Gg          , Gd          , Gs          , Gg          , Gs          , Gg          , Gs          , Gs          , Gs          , Gs          , Gs^Fp       , Gs^Fp       , Gs^Fp       , Gs^Fp       , Gs^Fp       , Re^Gvs      , Gg          , Gs^Vc       , Gg          , Re^Gvs      , Re^Gvs      , Re^Gvs      , Re^Gvs      , Re^Gvs      , Gs^Fp       , Gs^Fp       , Gs          , Ds          , Ww          , Ww          , Re^Gvs      , Re^Gvs      , Re^Gvs      , Gg          , Gg          
Gll         , Gll         , Gs          , Gg          , Re          , Re          , Re          , Re          , Gs          , Gs          , Gs          , Gd          , Gd          , Gd          , Gd          , Gg          , Gg          , Gg          , Gg          , Gg          , Re^Gvs      , Re^Gvs      , Re^Gvs      , Gg          , Re^Gvs      , Re^Gvs      , Re^Gvs      , Re^Gvs      , Re^Gvs      , Re^Gvs      , Wwf         , Re^Gvs      , Re^Gvs      , Re^Gvs      , Re^Gvs      , Re^Gvs      , Re^Gvs      , Gs          , Ds          , Ww          , Ww          , Re^Gvs      , Re^Gvs      , Re^Gvs      , Re^Gvs      , Gg          
Gs          , Gs          , Gd          , Gd          , Re          , Re          , Re          , Re          , Gs          , Gs          , Gs          , Gs          , Gs          , Gg          , Gg          , Gg          , Gg          , Gg          , Gg          , Gg          , Re^Gvs      , Wwf         , Ww          , Re^Gvs      , Re^Gvs      , Re^Gvs      , Re^Gvs      , Re^Gvs      , Re^Gvs      , Re^Gvs      , Re^Gvs      , Ww          , Ww          , Re^Gvs      , Re^Gvs      , Re^Gvs      , Re^Gvs      , Gs^Vc       , Ww^Bw\      , Ww          , Ww          , Re^Gvs      , Re^Gvs      , Re^Gvs      , Re^Gvs      , Re^Gvs      
Gll         , Gll         , Gs          , Gd          , Gd          , Re          , Re          , Re          , Gg          , Gs          , Gs          , Gs          , Gg          , Gg          , Re^Gvs      , Gg          , Gg          , Gg          , Re^Gvs      , Gg          , Gs^Vc       , Re^Gvs      , Re^Gvs      , Ww          , Ww          , Re^Gvs      , Re^Gvs      , Re^Gvs      , Re^Gvs      , Re^Gvs      , Re^Gvs      , Re^Gvs      , Re^Gvs      , Ww          , Ww          , Re^Gvs      , Ww          , Ww          , Ww          , Ww          , Re^Gvs      , Ww          , Ww          , Re^Gvs      , Re^Gvs      , Re^Gvs      
Gll         , Gs          , Gs          , Gs          , Gs          , Re          , Re          , Re          , Gg          , Gs          , Gs          , Gs^Vc       , Gg          , Re^Gvs      , Wwf         , Re^Gvs      , Re^Gvs      , Re^Gvs      , Wwf         , Re^Gvs      , Re^Gvs      , Re^Gvs      , Wwf         , Ww          , Re^Gvs      , Ww          , Ww          , Re^Gvs      , Re^Gvs      , Re^Gvs      , Re^Gvs      , Re^Gvs      , Ww          , Ww          , Ww          , Ww          , Ww          , Ww          , Re^Gvs      , Re^Gvs      , Re^Gvs      , Re^Gvs      , Re^Gvs      , Ww          , Wwf         , Gg          
Gll         , Gs          , Gs          , Gs          , Gs          , Re          , Re          , Re          , Gg          , Gs          , Gs          , Gs          , Gs          , Re^Gvs      , Re^Gvs      , Ww          , Ww          , Ww          , Re^Gvs      , Re^Gvs      , Re^Gvs      , Re^Gvs      , Re^Gvs      , Re^Gvs      , Re^Gvs      , Re^Gvs      , Re^Gvs      , Ww          , Ww          , Re^Gvs      , Ww          , Ww          , Ww          , Ww          , Ww          , Ww          , Re^Gvs      , Re^Gvs      , Re^Gvs      , Re^Gvs      , Re^Gvs      , Re^Gvs      , Re^Gvs      , Re^Gvs      , Re^Gvs      , Gg          
Gll         , Gll         , Gll         , Gs          , Gs          , Re          , Re          , Re          , Gg          , Gs          , Gs          , Gs          , Gs          , Gg          , Gg          , Re^Gvs      , Re^Gvs      , Ww          , Ww          , Re^Gvs      , Re^Gvs      , Gg          , Gg          , Gg          , Re^Gvs      , Re^Gvs      , Re^Gvs      , Re^Gvs      , Re^Gvs      , Ww          , Ww          , Ww          , Re^Gvs      , Re^Gvs      , Re^Gvs      , Ww          , Ww          , Re^Gvs      , Re^Gvs      , Re^Gvs      , Re^Gvs      , Re^Gvs      , Re^Gvs      , Re^Gvs      , Re^Gvs      , Re^Gvs      
Gs^Fp       , Gll         , Gll         , Gg          , Gg          , Re          , Re          , Re          , Re          , Gg          , Gg          , Gg          , Gg          , Gs          , Gs          , Gg          , Gg          , Re^Gvs      , Re^Gvs      , Ww          , Re^Gvs      , Gg          , Gg          , Gg          , Re^Gvs      , Re^Gvs      , Re^Gvs      , Re^Gvs      , Re^Gvs      , Ww          , Re^Gvs      , Re^Gvs      , Re^Gvs      , Re^Gvs      , Re^Gvs      , Re^Gvs      , Re^Gvs      , Ww          , Ww          , Re^Gvs      , Re^Gvs      , Re^Gvs      , Re^Gvs      , Re^Gvs      , Re^Gvs      , Re^Gvs      
Gs^Fp       , Gs^Fp       , Gll         , Gll         , Gg          , Re          , Re          , Re          , Re          , Re          , Re          , Gg^Vh       , Rp          , Gg          , Gg          , Gg          , Gg          , Re^Gvs      , Re^Gvs      , Ww          , Ww          , Re^Gvs      , Re^Gvs      , Re^Gvs      , Re^Gvs      , Re^Gvs      , Re^Gvs      , Re^Gvs      , Ww          , Ww          , Re^Gvs      , Re^Gvs      , Re^Gvs      , Re^Gvs      , Re^Gvs      , Re^Gvs      , Re^Gvs      , Re^Gvs      , Re^Gvs      , Ww          , Ww          , Re^Gvs      , Re^Gvs      , Re^Gvs      , Re^Gvs      , Re^Gvs      
Gs^Fp       , Gs^Fp       , Gll         , Gg          , Gg          , Gg          , Gg^Vh       , Re          , Re          , Re          , Re          , Rp          , Rp^Vhc      , Rp          , Rp          , Gg          , Gg          , Re^Gvs      , Wwf         , Ww          , Re^Gvs      , Ww          , Ww          , Re^Gvs      , Re^Gvs      , Re^Gvs      , Re^Gvs      , Re^Gvs      , Ww          , Ww          , Ds          , Re^Gvs      , Gs          , Gg          , Gg          , Re^Gvs      , Re^Gvs      , Re^Gvs      , Re^Gvs      , Re^Gvs      , Re^Gvs      , Ww          , Wwf         , Re^Gvs      , Re^Gvs      , Re^Gvs      
Gs^Fp       , Gs^Fp       , Gll         , Gll         , Gll         , Gg          , Gg          , Re          , Re          , Re          , Re          , 1 Rp        , Rp          , Rp          , Rp          , Rp          , Gg          , Re^Gvs      , Re^Gvs      , Re^Gvs      , Gg          , Re^Gvs      , Re^Gvs      , Ww          , Ww          , Wwf         , Ww          , Ww          , Ds          , Ds          , Gs          , Gs          , Gs^Fp       , Gs          , Gs          , Gs          , Gs          , Re^Gvs      , Re^Gvs      , Re^Gvs      , Re^Gvs      , Re^Gvs      , Re^Gvs      , Re^Gvs      , Re^Gvs      , Re^Gvs      
Gs^Fp       , Gs^Fp       , Gs^Fp       , Gll         , Gll         , Gg          , Gg          , Gg          , Re          , Re          , Re          , Re          , Gg^Vh       , Rp          , Rp          , Rp          , Gg          , Gg          , Gg          , Gg          , Gg          , Gg          , Gg          , Re^Gvs      , Ww          , Ww          , Ww          , Ds          , Gs          , Gs          , Gs^Fp       , Gs^Fp       , Gs^Fp       , Gs^Fp       , Gs^Fp       , Gs^Fp       , Gs^Fp       , Gs          , Gs          , Re^Gvs      , Re^Gvs      , Re^Gvs      , Re^Gvs      , Re^Gvs      , Re^Gvs      , Re^Gvs      
Gs^Fp       , Gs^Fp       , Gs^Fp       , Gll         , Gll         , Gg          , Gg          , Gg          , Gg^Vh       , Re          , Re          , Re          , Re          , Re          , Re          , Rp          , Re          , Gg          , Re          , Gg          , Gs^Vc       , Gg          , Ww          , Ww          , Ww          , Ww          , Re^Gvs      , Gs          , Gs^Fp       , Gs^Fp       , Gs^Fds      , Gs^Fds      , Gs^Fp       , Gs^Fp       , Gs^Fp       , Gs^Fp       , Gs^Fp       , Gs          , Gs          , Gg          , Gg          , Re^Gvs      , Gg          , Gg          , Gg          , Gg          
Gs^Fp       , Gs^Fp       , Gs^Fp       , Gll         , Gs          , Gs          , Gs          , Gg          , Gg          , Re          , Re          , Re          , Re          , Re          , Re          , Re          , Re          , Re          , Re          , Re          , Ww          , Ww          , Ww          , Ww          , Gg          , Re^Gvs      , Gg          , Gs          , Gs^Fp       , Gs^Fp       , Gs^Fp       , Gs^Fds      , Gs^Fp       , Gs^Fp       , Gs^Fp       , Gs^Fp       , Gs^Fp       , Gs          , Gs          , Gg          , Gg          , Gg          , Gg          , Gg          , Gg          , Gg          
Gs^Fp       , Gs^Fp       , Gs^Fp       , Gll         , Gll         , Gs          , Gll         , Gg          , Gg          , Gg          , Gg          , Re          , Re          , Re          , Re          , Re          , Re          , Ce          , Ww          , Ww^Bw\      , Ww^Bw\      , Ww          , Re          , Gg          , Gg          , Gg          , Gg          , Gs          , Gs^Fp       , Gs^Fp       , Gs^Fp       , Gs^Fp       , Gs^Fp       , Gs^Fp       , Gs^Fds      , Gs^Fds      , Gs^Fds      , Gs          , Gg          , Gg          , Gg          , Gg          , Gg          , Gg          , Gg          , Gg          
Gs^Fp       , Gs^Fp       , Gs^Fp       , Gs^Fp       , Gs^Fp       , Gll         , Gs          , Gg          , Gg          , Gg          , Ch          , Gg          , Gg          , Re          , Gg          , Re          , Ww          , Ww          , Ww          , Ww          , Ce          , Re          , Re          , Re          , Re          , Gg          , Gg^Vh       , Gs          , Gs^Fp       , Gs^Fp       , Gs^Fp       , Gs^Fp       , Gs^Fp       , Gs^Fp       , Gs^Fp       , Gs^Fds      , Gs          , Gs          , Gg          , Gg          , Gg          , Gg          , Gg          , Gg          , Gg          , Gg          
Gs^Fp       , Gs^Fp       , Gs^Fp       , Gs^Fp       , Gs^Fp       , Gs^Fp       , Gs^Fp       , Gs          , Gg          , Gg          , Kh          , Gg          , Gg          , Gg          , Ds          , Ww          , Ww          , Ww          , Gg          , Gg          , Gg          , Re          , Re          , Re          , Re          , Re          , Re          , Gs          , Gs          , Gs^Fp       , Gs^Fp       , Gs^Fp       , Gs          , Gs^Fp       , Gs          , Gs          , Gg          , Gg          , Gg          , Gg          , Re          , Gg          , Re          , Re          , Re          , Re          
Gs^Fp       , Gs^Fp       , Gs^Fp       , Gs^Fp       , Gs^Fp       , Gs^Fp       , Gs^Fp       , Gs          , Gs          , Ch          , Gg          , Ch          , Gg          , Ds          , Ww          , Ww          , Ww          , Gg          , Gg          , Gg          , Gg          , Gg          , Gg          , Re          , Re          , Re          , Re          , Re          , Re          , Re          , Re          , Gs          , Re          , Gs          , Re          , Gg          , Re          , Gg          , Re          , Re          , Re          , Ch          , Re          , Re          , Re          , Re          
Gs^Fp       , Gs^Fp       , Gs^Fp       , Gs^Fp       , Gs^Fp       , Gs^Fp       , Gs^Fp       , Gs^Fp       , Gs^Fp       , Gs          , Gs          , Gg          , Ds          , Ds          , Ww          , Ww          , Re^Gvs      , Re^Gvs      , Re^Gvs      , Gg          , Gg          , Gg          , Gg          , Gg          , Gg          , Re          , Re          , Re          , Re          , Re          , Re          , Re          , Re          , Re          , Re          , Re          , Re          , Re          , Re          , Re          , Re          , Re          , Re          , Re          , Re          , Re          
Gs^Fp       , Gs^Fp       , Gs^Fp       , Gs^Fp       , Gs^Fp       , Gs^Fp       , Gs^Fp       , Gs^Fp       , Gs^Fp       , Gs^Fp       , Gs^Fp       , Gs          , Ww          , Ww          , Ww          , Ww          , Ww          , Re^Gvs      , Re^Gvs      , Re^Gvs      , Re^Gvs      , Gg          , Re^Gvs      , Gg          , Gg          , Gg          , Gg          , Re          , Re          , Re          , Re          , Re          , Re          , Re          , Re          , Re          , Re          , Re          , Re          , Re          , Re          , Re          , Gg          , Gg          , Gg          , Gg          
Gs^Fp       , Gs^Fp       , Gs^Fp       , Gs^Fp       , Gs^Fp       , Gs^Fp       , Gs^Fp       , Gs^Fp       , Gs^Fp       , Gs^Fp       , Ww          , Ww          , Ww          , Ww          , Re^Gvs      , Re^Gvs      , Re^Gvs      , Wwf         , Ww          , Re^Gvs      , Re^Gvs      , Re^Gvs      , Wwf         , Re^Gvs      , Re^Gvs      , Gg          , Gg          , Gg          , Gg          , Re          , Rp          , Rp          , Rp          , Re          , Rp          , Re          , Rp          , Rp          , Rp          , Re          , Gg          , Ch          , Gg          , Gg          , Gg          , Gg          
Gs^Fp       , Gs^Fp       , Gs^Fp       , Gs^Fp       , Gs^Fp       , Gs^Fp       , Gs^Fp       , Gs^Fp       , Ww          , Wwf         , Ww          , Ww          , Gs^Vc       , Gg          , Gg          , Re^Gvs      , Re^Gvs      , Re^Gvs      , Re^Gvs      , Ww          , Ww          , Ww          , Re^Gvs      , Re^Gvs      , Re^Gvs      , Gg          , Gg          , Gg          , Gg          , Re          , Rp          , Rp          , Rp          , Rp          , Rp          , Rp          , Rp          , Rp          , Rp          , Gg          , Gg          , Gg          , Gg          , Gg          , Gg          , Gg          
Gs^Fp       , Gs^Fp       , Gs^Fp       , Gs^Fp       , Gs^Fp       , Gs^Fp       , Ww          , Ww          , Ww          , Ww          , Ww          , Gs^Fp       , Gg          , Gg          , Gg          , Gg          , Re^Gvs      , Re^Gvs      , Re^Gvs      , Re^Gvs      , Ww          , Ww          , Ww          , Re^Gvs      , Re^Gvs      , Re^Gvs      , Re^Gvs      , Gg          , Gg          , Re          , Gg          , Rp          , Rp          , Rp          , Ch          , Rp          , Rp          , Rp          , Gg^Vh       , Gg          , Gg          , Gg          , Gg          , Gg          , Gg          , Gg          
Gs^Fp       , Gs^Fp       , Gs^Fp       , Gs^Fp       , Ww          , Ww          , Ww          , Ww          , Gs^Fp       , Gs^Fp       , Gs^Fp       , Gs^Fp       , Gs^Fp       , Gg          , Gg          , Gg          , Re^Gvs      , Re^Gvs      , Wwf         , Ww          , Re^Gvs      , Re^Gvs      , Re^Gvs      , Ww          , Wwf         , Re^Gvs      , Re^Gvs      , Gg          , Gg          , Re          , Gg^Vh       , Rp          , Rp          , Ch          , 2 Kh        , Ch          , Rp          , Rp          , Gg          , Gg          , Gg          , Gg          , Gg          , Gg          , Gg          , Gg          
Gs^Fp       , Gs^Fp       , Gs^Fp       , Gs^Fp       , Ww          , Ww          , Gg          , Gg          , Gg          , Gs^Fp       , Gs^Fp       , Gs^Fp       , Gs^Fp       , Gg          , Gg          , Gg          , Gg          , Re^Gvs      , Re^Gvs      , Re^Gvs      , Re^Gvs      , Re^Gvs      , Re^Gvs      , Re^Gvs      , Re^Gvs      , Re^Gvs      , Gg          , Gg          , Gg          , Re          , Gg          , Rp          , Rp          , Ch          , Ch          , Ch          , Rp          , Rp          , Gg          , Gg          , Gg          , Gg          , Gg          , Gg          , Gg          , Gg          
Gg          , Gs^Fp       , Gs^Fp       , Ww          , Ww          , Ww          , Gg          , Gg          , Re^Gvs      , Re^Gvs      , Gs^Fp       , Gs^Fp       , Gs^Fp       , Gs^Fp       , Gg          , Gg          , Gg          , Gg          , Gg          , Re^Gvs      , Gg          , Gg          , Gg          , Gs^Vc       , Gg          , Gg          , Gg          , Gg          , Gg          , Re          , Re          , Gg^Wm       , Rp          , Rp          , Rp          , Rp          , Rp          , Gg^Vh       , Gg          , Gg          , Gs^Fds      , Gg          , Gs^Fp       , Gs^Fp       , Gs^Fp       , Gg          
Gg          , Gg          , Gg          , Ww          , Ww          , Ww          , Ww          , Re^Gvs      , Re^Gvs      , Re^Gvs      , Re^Gvs      , Gs^Fp       , Gs^Fp       , Gs^Fp       , Gg          , Gg          , Gg          , Gg          , Gg          , Gg          , Gg          , Gg          , Gg          , Gg          , Gg          , Gg          , Gg          , Gg          , Gs          , Gg          , Re          , Gg          , Gg^Vh       , Rp          , Gg          , Rp          , Gg          , Gg          , Gg          , Gs^Fds      , Gs^Fds      , Gs^Fds      , Gs^Fp       , Gs^Fp       , Gs^Fp       , Gs^Fp       
Gg          , Gg          , Gg          , Ww          , Ww          , Ww          , Ww          , Gs^Vc       , Ww          , Ww          , Ww          , Re^Gvs      , Re^Gvs      , Gg          , Gg          , Gg          , Gg          , Gg          , Gg          , Gg          , Gg          , Gg          , Gg          , Gg          , Gg          , Gg          , Gg          , Gg          , Gs          , Gs          , Gs          , Re          , Gg          , Gg          , Gg          , Gg          , Gs          , Gg          , Gg          , Gg          , Gs^Fds      , Gs^Fds      , Gs^Fp       , Gs^Fp       , Gs^Fp       , Gs^Fp       
Gg          , Gg          , Ds          , Ww          , Ww          , Ww          , Ww          , Ww          , Gg          , Re^Gvs      , Re^Gvs      , Ww          , Wwf         , Re^Gvs      , Re^Gvs      , Gg          , Gg          , Gg          , Gg          , Gg          , Gg          , Gg          , Gg          , Gg          , Gg          , Gg          , Gg          , Gg          , Gg          , Gs          , Gg          , Gs          , Gs          , Gg          , Gs          , Gs          , Gg          , Gg          , Gs^Fds      , Gs^Fds      , Gs^Fds      , Gs^Fds      , Gs^Fp       , Gs^Fp       , Gs^Fp       , Gs^Fp       
Gg          , Gg          , Ds          , Ww          , Ww          , Ww          , Ww          , Gg          , Gg          , Gg          , Gg          , Re^Gvs      , Re^Gvs      , Re^Gvs      , Gg          , Gg          , Gg          , Gg          , Gg          , Gg          , Mm^Xm       , Mm^Xm       , Mm^Xm       , Mm^Xm       , Mm^Xm       , Mm^Xm       , Mm^Xm       , Gg          , Mm^Xm       , Gg          , Gg          , Gs          , Gs          , Gs          , Gg          , Gg          , Gs^Fp       , Gs^Fp       , Gs^Fp       , Gs^Fp       , Gs^Fp       , Gs^Fp       , Gs^Fp       , Gs^Fp       , Gs^Fp       , Gs^Fp       
Gg          , Gg          , Ds          , Ww          , Ww          , Ww          , Ww          , Gg          , Gg          , Gg          , Gg          , Gg          , Gg          , Re^Gvs      , Gg          , Gg          , Gg          , Gg          , Gg          , Mm^Xm       , Mm^Xm       , Mm^Xm       , Mm^Xm       , Mm^Xm       , Mm^Xm       , Mm^Xm       , Mm^Xm       , Mm^Xm       , Mm^Xm       , Mm^Xm       , Mm^Xm       , Gg          , Gg          , Gs          , Gg          , Gs^Fp       , Gs^Fp       , Gs^Fp       , Gs^Fp       , Gs^Fp       , Gs^Fp       , Gs^Fp       , Gs^Fp       , Gs^Fp       , Gs^Fp       , Gs^Fp       
