border_size=1
usage=map

Mm          , Mm          , Mm          , Mm          , Mm          , Mm          , Mm          , Hh          , Gll^Fp      , Gg          , Gg          , Gg          , Gg          , Gg          , Gs^Fp       , Gs^Fp       , Gg          , Gg          , Gg          , Gg          , Gg          , Rb          , Gg          , Gg          , Gs^Fp       , Gs^Fp       , Gs^Fp       , Gs^Fp       , Hh^Fp       , Hh^Fp       , Hh          , Hh          , Hh          , Hh          , Hh          , Hh          , Mm          , Mm          , Mm          , Mm          , Mm          , Hh          , Hh          , Hh          , Hh          , Hh          
Mm          , Mm          , Hh          , Mm          , Hh          , Mm          , Hh          , Hh          , Hh^Fp       , Gll^Fp      , Gg          , Gg          , Ss          , Gg          , Gg          , Gs^Fp       , Gg          , Gg          , Gg          , Gg          , Gg          , Rb          , Gg          , Gs^Fp       , Gs^Fp       , Gs^Fp       , Gs^Fp       , Gs^Fp       , Hh^Fp       , Hh^Fp       , Hh          , Hh          , Hh          , Hh          , Hh          , Hh          , Mm          , Mm          , Mm          , Mm          , Mm          , Hh          , Hh          , Hh          , Hh          , Hh          
Hh          , Hh          , Hh          , Mm          , Hh          , Hh          , Mm          , Hh          , Gll^Fp      , Gll^Fp      , Ss          , Ss          , Ss          , Ss          , Ss          , Gg          , Ss          , Ss          , Ss          , Gg          , Gg          , Rb          , Gg          , Gs^Fp       , Gs^Fp       , Gs^Fp       , Gs^Fp       , Gs^Fp       , Gs^Fp       , Hh^Fp       , Hh          , Hh          , Hh          , Hh          , Hh          , Hh          , Mm          , Mm          , Mm          , Mm          , Mm          , Hh          , Hh^Fmw      , Hh          , Hh          , Hh          
Hh^Fp       , Hh          , Hh          , Hh          , Hh          , Hh          , Hh          , Hh          , Gll^Fp      , Gll^Fp      , Gll^Fp      , Ss          , Ss          , Ss          , Ss          , Ss          , Ww          , Ww          , Ww          , Ss          , Ss          , Rb          , Rb          , Gg          , Gg          , Gs^Fp       , Gs^Fp       , Gs^Fp       , Gs^Fp       , Hh^Fp       , Hh^Fp       , Hh          , Hh          , Hh          , Mm          , Mm          , Mm          , Mm          , Mm          , Mm          , Mm          , Hh          , Hh          , Hh          , Hh          , Hh          
Gll^Fp      , Hh^Fp       , Gll^Fp      , Hh^Fp       , Gll^Fp      , Hh^Fp       , Hh^Fp       , Hh^Fp       , Hh^Fp       , Gll^Fp      , Hh^Fp       , Gll^Fp      , Ww          , Ww          , Ww          , Ww          , Ss          , Ww          , Ww          , Ww          , Ss          , Ss          , Rb          , Gg          , Gg          , Gs^Fp       , Gs^Fp       , Gs^Fp       , Gs^Fp       , Hh^Fp       , Hh^Fp       , Hh^Fp       , Hh          , Hh          , Mm          , Mm          , Mm          , Mm          , Mm          , Mm          , Mm          , Mm          , Hh          , Hh          , Hh          , Hh          
Gll^Fp      , Gll^Fp      , Gll^Fp      , Gll^Fp      , Gll^Fp      , Gll^Fp      , Gll^Fp      , Gll^Fp      , Gll^Fp      , Gll^Fp      , Gll^Fp      , Gll^Fp      , Ww          , Ww          , Ww          , Ss          , Ss^Vhs      , Ss          , Ss          , Ss          , Gg          , Gg          , Gg          , Rb          , Rb          , Re^Vct      , Rb          , Gs^Fms      , Hh^Fp       , Hh^Fp       , Gs^Fp       , Hh^Fp       , Hh^Fp       , Hh          , Hh          , Mm          , Mm          , Mm          , Mm          , Mm          , Mm          , Hh          , Hh^Fdw      , Hh          , Hh          , Hh          
Gll^Fp      , Gll^Fp      , Gll^Fp      , Gll^Fp      , Gll^Fp      , Gll^Fp      , Gll^Fp      , Gll^Fp      , Ss          , Ww          , Ww          , Ww          , Ss          , Ww          , Ce          , Ss          , Ss          , Ss          , Gg          , Gg          , Gg          , Gg          , Gg          , Gg          , Rb          , Rb          , Gg          , Gs^Fds      , Gs^Fms      , Gs^Fp       , Hh^Fds      , Hh^Fp       , Gll         , Gs^Fp       , Hh          , Hh          , Mm          , Mm          , Mm          , Mm          , Mm          , Mm          , Hh          , Hh          , Hh          , Hh          
Gg          , Gll^Fp      , Ss          , Gll^Fp      , Ss          , Ss          , Ss          , Ss          , Ss          , Ss          , Ss          , Ss          , Wwf         , Ce          , Ce          , 1 Ke        , Ce          , Wwf         , Wwf         , Gg          , Gs          , Gg          , Rb          , Rb          , Rb          , Gg          , Gs          , Gs          , Gg          , Gs^Fms      , Gs          , Gg          , Gll         , Gs^Fp       , Hh^Fp       , Hh          , Hh          , Hh          , Hh          , Mm          , Hh          , Hh          , Hh^Fmw      , Gll^Fp      , Gll^Fp      , Hh          
Gg          , Gg          , Gg          , Gg          , Gg          , Gg          , Gg          , Ss          , Ss          , Ss          , Ss          , Ss          , Wwf         , Ss          , Ww          , Ce          , Ww          , Ss          , Ww          , Ss          , Ss          , Rb          , Gg          , Gg          , Gg          , Rb          , Rb          , Gs          , Rb          , Rb          , Gd          , Gg          , Gg          , Gs^Fp       , Gs^Fp       , Gs^Fp       , Gg          , Hh          , Gg          , Hh          , Gg          , Hh          , Gll^Fp      , Ss          , Ss          , Gll^Fp      
Hh          , Gg          , Gg          , Gg          , Gll^Fp      , Gll^Fp      , Gll^Fp      , Gll^Fp      , Gll^Fp      , Gll^Fp      , Ss          , Wwf         , Ss          , Ss          , Ww          , Ww          , Ww          , Ww          , Ww          , Ss^Vhs      , Gs          , Gs          , Gs          , Re^Vct      , Gg          , Rb          , Rb          , Rb          , Gg          , Gg          , Gg          , Rb          , Gd          , Gg          , Gg          , Gg          , Gg          , Gg          , Gg          , Gg          , Ss^Vhs      , Ss          , Ss          , Ss          , Ss          , Ss          
Hh          , Hh          , Gg          , Gg          , Gll^Fp      , Gll^Fp      , Gll^Fp      , Gll^Fp      , Gll^Fp      , Gll^Fp      , Gg          , Wwf         , Ss          , Ss          , Ww          , Ww          , Ww          , Ww          , Ww          , Ss          , Gs          , Gs          , Gs          , Gs          , Gg          , Gg          , Rb          , Gg          , Gs          , Gg          , Gg          , Gs          , Gs          , Gs          , Gg          , Gg          , Gg          , Gg          , Gs^Fp       , Gg          , Ss          , Ss          , Ctys        , Ctys        , Gs^Fp       , Gs^Fp       
Gg          , Gg          , Gg          , Gg          , Gs          , Ww          , Gll^Fp      , Gll^Fp      , Gg          , Gs^Vht      , Gg          , Gg          , Ss          , Ss          , Ss          , Ww          , Ww          , Ww          , Wwf         , Ss          , Ds          , Gs          , Gs          , Gs          , Ds          , Gg          , Rb          , Gs          , Rb          , Gg          , Gg          , Gg          , Gg          , Gg          , Gg          , Gg          , Gg          , Gs^Fp       , Gs^Fp       , Ss          , Ss          , Ss          , Ss          , 2 Ktys      , Ctys        , Ss          
Gg          , Gg          , Gs^Vht      , Gs          , Gs          , Gll^Fp      , Gs          , Gg          , Gs^Ft       , Gg          , Gs^Ft       , Gg          , Gg          , Ss          , Ss          , Ss          , Ww          , Ww          , Wwf         , Ss          , Ww          , Ds          , Ww          , Ds          , Ww          , Ww          , Wwf         , Ww          , Ww          , Gg          , Hh          , Hh          , Hh          , Gs^Fp       , Gs^Fp       , Gs^Fp       , Gs^Fp       , Gg          , Gg          , Ss          , Ss          , Ss          , Ss          , Ctys        , Ss          , Ss          
Ds          , Gs          , Gs          , Gs          , Gs          , Gs          , Gs          , Gs          , Gs          , Gg          , Gs^Ft       , Gg          , Gg          , Gg          , Gg          , Ss          , Ss          , Wwf         , Ww          , Ww          , Ss          , Ss          , Ds          , Ww          , Wo          , Wo          , Wwf         , Wo          , Wo          , Ww          , Ww          , Hh          , Hh          , Hh^Fp       , Gs^Fms      , Gs^Fp       , Hh^Fp       , Gs^Fp       , Ww          , Ww          , Wo          , Ww          , Ss          , Ss          , Ss          , Gs^Fp       
Ww          , Ds          , Gs^Ft       , Gs          , Gs          , Gs          , Gs^Ft       , Gs^Ft       , Gs          , Gs^Ft       , Gs          , Gs^Ft       , Gg          , Gg          , Hh          , Gg          , Ss          , Ss          , Ww          , Ww          , Ss          , Gg          , Ds          , Wwf         , Wwf         , Ww          , Rd          , Ww          , Ww          , Wo          , Wo          , Ww          , Ww          , Gs^Fds      , Ww          , Gs^Fds      , Wo          , Wo          , Wo          , Wo          , Gs^Vht      , Wo          , Ss          , Ss          , Ss          , Ss          
Ww          , Ww          , Ds          , Gs          , Ds          , Gg          , Gs          , Gs          , Gs          , Gs          , Gs^Ft       , Gs^Ft       , Gg          , Gg          , Gg          , Gg          , Ss          , Ss          , Ww          , Ww          , Ss          , Gs          , Ds          , Ww          , Ds          , Rd          , Gs^Vht      , Ds          , Ds          , Ww          , Ww          , Wo          , Wo          , Ww          , Wo          , Wo          , Wo          , Wo          , Ww          , Ds          , Ds          , Gs          , Ww          , Ss^Vhs      , Wo          , Ss          
Ww          , Ww          , Wo          , Ds          , Ww          , Ds          , Gs^Ft       , Gs          , Gs^Ft       , Gs          , Gg          , Gs          , Hh          , Hh^Fdw      , Hh          , Gg          , Ss          , Ss          , Ww          , Ww          , Ww          , Ss          , Rd          , Ww          , Ds          , Gs          , Re          , Gs          , Ww          , Ww          , Ds          , Ww          , Ww          , Wo          , Ww          , Ww          , Ww          , Wo          , Wo          , Wo          , Wo          , Ww          , Wo          , Wo          , Wo          , Wo          
Wo          , Wo          , Wo          , Wo          , Wo          , Ww          , Ww          , Ds          , Ds          , Gg          , Gs^Vht      , Gs          , Gs          , Mm          , Mm          , Hh          , Gg          , Ss          , Ww          , Ww          , Ww          , Ww          , Wwf         , Ww          , Ww          , Ds          , Re          , Ww          , Ds          , Ds          , Gg          , Ds          , Ds          , Ww          , Ds          , Ds          , Ds          , Ww          , Ds          , Ww          , Ww          , Ww          , Ww          , Ww          , Wo          , Wo          
Wo          , Wo          , Wo          , Wo          , Wo          , Wo          , Wo          , Ww          , Ww          , Ds          , Ds          , Gs          , Gg          , Hh^Fdw      , Hh          , Hh          , Gg          , Gg          , Ww          , Ww          , Wo          , Wo          , Ww          , Wwf         , Ds          , Ww          , Gs          , Re          , Gg          , Gg          , Gs^Ft       , Gs^Ft       , Gs^Ft       , Ds          , Gs^Ft       , Gs^Ft       , Gs^Ft       , Ds          , Ds          , Ww          , Ww          , Ds          , Ww          , Ww          , Ww          , Wo          
Ww          , Wo          , Ww          , Ww          , Ww          , Ww          , Ww          , Wo          , Ww          , Wwf         , Ds          , Gs          , Gg          , Gg          , Gs          , Gs          , Ds          , Ww          , Wo          , Wo          , Wo          , Ww          , Ds          , Rd          , Re          , Ds          , Gg          , Re          , Gg          , Gg          , Gs^Ft       , Gs^Ft       , Gs^Ft       , Gs^Ft       , Gs^Ft       , Gs^Ft       , Gs^Ft       , Gs^Ft       , Ds          , Ww          , Ww          , Ds          , Ds          , Ww          , Ww          , Ww          
Ds          , Ww          , Ds          , Ds          , Ds          , Ds          , Ds          , Ww          , Wo          , Ww          , Ww          , Ds          , Ds          , Gg          , Gs          , Ds          , Wwf         , Ww          , Ww          , Ww          , Ww          , Ww          , Ds          , Gs          , Gg          , Re          , Re          , Re          , Re          , Re          , Gg          , Gs^Ft       , Gg          , Gs^Ft       , Gg          , Gg          , Gg          , Gg          , Gs          , Ds          , Ds          , Ds          , Ds          , Ww          , Ww          , Ww          
Rd          , Ds          , Rd          , Rd          , Dd^Vdt      , Ds          , Ds          , Ww          , Ww          , Wo          , Ww          , Ds          , Ww          , Ds          , Gs^Ft       , Ds          , Ww          , Wwf         , Ds          , Ds          , Ds          , Ds          , Gs          , Gs          , Gg          , Gg          , Gg          , Gg          , Gg          , Re          , Re          , Gg          , Gg          , Gg          , Gg          , Gg          , Gs          , Gg          , Gs          , Gd          , Gd          , Ds          , Ds          , Ds          , Ds          , Ww          
Ds          , Ds          , Ds          , Rd          , Ds          , Ds          , Ds          , Ds          , Ww          , Wo          , Wo          , Ww          , Wo          , Ww          , Ww          , Ww          , Wo          , Ww          , Ds          , Gs          , Gs          , Gs          , Gg          , Gg          , Gs          , Gs^Ft       , Gg          , Hh          , Hh          , Gg          , Ds          , Ds          , Re          , Re^Vct      , Re          , Gs^Ft       , Re          , Gs          , Gg          , Gd          , Gs^Ft       , Gs          , Ds          , Ds          , Ww          , Ww          
Ds          , Ds          , Ds          , Ds          , Ds          , Rd          , Rd          , Ds          , Ds          , Ww          , Ww          , Wo          , Ww          , Wo          , Wo          , Wo          , Ww          , Ww          , Ds          , Gs          , Gg          , Gs^Ft       , Gg          , Gg          , Hh          , Gg          , Ce          , Hh          , Hh          , Gg          , Re          , Ds          , Re          , Re          , Gg          , Re          , Gs          , Re          , Re          , Gg          , Gg          , Gs          , Gs          , Ds          , Ww          , Wo          
Ds          , Ds          , Ds          , Ds          , Ds          , Ds          , Ds          , Rd          , Ds          , Ds          , Ds          , Ww          , Ds          , Ww          , Wwf         , Wo          , Ww          , Ds          , Ds          , Gs          , Gs          , Gs^Vht      , Gs^Ft       , Gg          , Gg          , Ce          , 4 Ke        , Re^Vct      , Re          , Re          , Gg          , Re          , Ds          , Gg          , Gg          , Gg          , Gs          , Gs          , Re          , Gs          , Gg          , Gg          , Gs          , Ds          , Ds          , Ww          
Ds          , Ds          , Ds          , Ds          , Ds          , Ds          , Ds          , Ds          , Rd          , Dd^Vdt      , Re          , Ds          , Ds          , Ww          , Ww          , Wo          , Wo          , Ww          , Ww          , Ds          , Gs          , Gs^Ft       , Gs^Ft       , Gs^Ft       , Gs^Ft       , Ce          , Gg          , Ce          , Gs^Ft       , Gs^Ft       , Gs^Ft       , Ds          , Ds          , Ds          , Gs^Ft       , Gg          , Gg          , Gg          , Re^Vct      , Gg          , Gs^Ft       , Gg          , Ds          , Ds          , Ds          , Ds          
Ds          , Ds          , Ds          , Ds          , Ds          , Ds          , Ds          , Ds          , Ds          , Rd          , Gs^Ft       , Ds          , Gs^Ft       , Ds          , Ds          , Ww          , Wo          , Ww          , Ww          , Ds          , Gs          , Gg          , Gs^Ft       , Gs^Ft       , Gs^Ft       , Gg          , Ds          , Ds          , Ds          , Gs^Ft       , Gs^Ft       , Ds          , Ds          , Ds          , Gs          , Gs          , Gs          , Gs          , Gs          , Gg          , Gg          , Gs^Ft       , Ds          , Ds          , Ww          , Ww          
Ds          , Ds          , Ds          , Ds          , Ds          , Ds          , Ds          , Ds          , Ds          , Ds          , Rd          , Rd          , Rd          , Ds          , Ww          , Ww          , Wo          , Ww          , Ds          , Ds          , Ds          , Gs          , Gg          , Gg          , Gg          , Gg          , Gs^Ft       , Ds          , Ds          , Gs^Ft       , Gg          , Gg          , Gs          , Gs          , Ds          , Ds          , Ds          , Ds          , Ds          , Gs          , Ds          , Ds          , Ds          , Ds          , Ww          , Ww          
Ds          , Ds          , Rd          , Ds          , Ds          , Ds          , Ds          , Ds          , Ds          , Ds          , Gs^Ft       , Rd          , Ds          , Rd          , Wwf         , Wwf         , Wwf         , Wwf         , Ds          , Ds          , Ds          , Gs          , Gs          , Gs          , Gs          , Gs^Ft       , Gs          , Ds          , Gs          , Gs          , Gs          , Gs          , Ds          , Ds          , Hd          , Ds          , Hd          , Ds          , Ds          , Ds          , Ds          , Ds          , Ds          , Ds          , Ww          , Ww          
Ds          , Ds          , Ds          , Rd          , Ds          , Ds          , Ds          , Ds          , Ds          , Ds          , Rd          , Ds          , Rd          , Rd          , Ww          , Ww          , Ww          , Ww          , Ww          , Ds          , Ds          , Gs^Ft       , Ds          , Gs          , Dd^Vdt      , Gs^Ft       , Ds          , Gs          , Ds          , Gs^Ft       , Ds          , Gs          , Ds          , Ds          , Rd          , Hd          , Dd^Vdt      , Hd          , Ds          , Ds          , Ds          , Ds          , Ds          , Ww          , Wo          , Wo          
Ds          , Rd          , Rd          , Rd          , Rd          , Rd          , Rd          , Ds          , Rd          , Rd          , Rd          , Rd          , Ds          , Ds          , Ww          , Ww          , Wo          , Ww          , Ww          , Ds          , Ds          , Ds          , Rd          , Rd          , Ds          , Ds          , Ds          , Ds          , Ds          , Ds          , Ds          , Ds          , Ds          , Ds          , Ds          , Rd          , Ds          , Ds          , Ds          , Ds          , Ds          , Ds          , Ds          , Ww          , Ww          , Wo          
Ds          , Ds          , Ds          , Ds          , Ds          , Ds          , Rd          , Rd          , Ds          , Ds          , Ds          , Ds          , Ds          , Ww          , Ww          , Wo          , Wo          , Ww          , Ww          , Ds          , Ds          , Ds          , Ds          , Ds          , Ds          , Ds          , Ds          , Ds          , Ds          , Ds          , Ds          , Ds          , Ww          , Ds          , Ww          , Ds          , Ds          , Ds          , Ww          , Ds          , Ww          , Ww          , Ww          , Ww          , Ww          , Ww          
Ds          , Ds          , Ds          , Ds          , Ds          , Ds          , Ds          , Ds          , Ds          , Ds          , Ds          , Ds          , Ww          , Ww          , Ww          , Wo          , Wo          , Wwr         , Wwr         , Ww          , Ww          , Ds          , Ww          , Ds          , Ww          , Ds          , Ww          , Ds          , Ww          , Ds          , Ww          , Ww          , Ww          , Ww          , Ww          , Ww          , Ww          , Ww          , Ww          , Ww          , Ww          , Ww          , Wo          , Ww          , Wo          , Wo          
Ds          , Ds          , 3 Ds        , Ds          , Ds          , Ds          , Ds          , Ds          , Ds          , Ds          , Ww          , Ww          , Ww          , Ww          , Wo          , Wo          , Wo          , Wo          , Wo          , Wwr         , Wo          , Ww          , Wwr         , Ww          , Ww          , Ww          , Wwr         , Ww          , Ww          , Ww          , Ww          , Ww          , Ww          , Ww          , Wo          , Ww          , Wo          , Ww          , Wo          , Wo          , Wo          , Wo          , Wo          , Wo          , Wo          , Wo          
Ds          , Ds          , Ds          , Ds          , Ds          , Ds          , Ds          , Ds          , Ww          , Ww          , Ww          , Ww          , Ww          , Wo          , Wo          , Wo          , Wo          , Wo          , Wo          , Wo          , Wo          , Wo          , Wo          , Wo          , Wo          , Wwr         , Wwr         , Wwr         , Wwr         , Ww          , Wo          , Wo          , Wo          , Wo          , Wo          , Wo          , Wo          , Wo          , Wo          , Wo          , Wo          , Wo          , Wo          , Wo          , Wo          , Wo          
