border_size=1
usage=map

Gd          , Gd          , Gd          , Gd          , Gd          , Gd          , Gd          , Gd          , Gs          , Gs          , Gs^Eff      , Gs^Gvs      , Gg^Gvs      , Gg^Gvs      , Gg^Gvs      , Gg^Gvs      , Gg^Gvs      , Gg^Gvs      , Gg^Gvs      , Gg^Gvs      , Gg          , Gll^Fp      , Gll^Fp      , Gll^Fp      , Gll^Fp      , Gll^Fp      , Gll^Fp      , Gll^Fp      , Gll^Fp      , Gll^Fp      , Hh          , Hh          , Mm          , Mm          , Mm          , Mm          , Mm          , Gg          , Mm          , Mm          , Mm          , Mm          , Mm          , Mm          , Re          , Re          
Ds          , Gd          , Gd          , Gd          , Gd          , Gd          , Gs          , Gs          , Gs          , Gs^Eff      , Gs^Eff      , Gs^Gvs      , Gg^Gvs      , Gg^Gvs      , Gg^Gvs      , Gg^Gvs      , Gg^Gvs      , Gg^Gvs      , Gg^Gvs      , Gg^Gvs      , Gg^Eff      , Gg          , Gg          , Gll^Fp      , Gg          , Gll^Fp      , Gll^Fp      , Gll^Fp      , Gll^Fp      , Hh^Fp       , Hh^Fp       , Hh          , Hh          , Mm          , Mm          , Mm          , Mm          , Mm          , Mm          , Mm          , Mm          , Mm          , Mm          , Re^Es       , Re          , Re          
Ds          , Gd          , Gs          , Gs          , Gs          , Gd          , Gs          , Gs          , Gs          , Gs          , Gg^Eff      , Gg^Eff      , Gg^Gvs      , Gg^Gvs      , Gg^Gvs      , Gg^Gvs      , Gg^Gvs      , Gg^Gvs      , Gg^Gvs      , Gg^Eff      , Gs^Eff      , Gg          , Gg          , Gg          , Gg          , Gg          , Gg          , Gg          , Gg          , Gg          , Hh          , Hh^Fp       , Hh          , Hh          , Mm          , Mm          , Hh          , Mm          , Mm          , Mm          , Mm          , Mm          , Mm          , Re          , Re^Es       , Re^Es       
Ds          , Ds          , Gs          , Gs          , Gs          , Gs          , Gs          , Gs          , Gs          , Gd          , Gs          , Gs^Eff      , Gs^Eff      , Gg^Gvs      , Gg^Gvs      , Gg^Gvs      , Gg^Gvs      , Gg^Gvs      , Gs^Eff      , Gs^Eff      , Gs          , Gg          , Gs          , Gg          , Gg          , Gg          , Gg          , Gg          , Gg          , Gg          , Gg          , Hh          , Hh          , Hh          , Hh          , Hh          , Hh          , Hh          , Gg          , Gg          , Gg          , Gg^Es       , Re          , Re          , Re          , Re          
Ds          , Ds          , Ds          , Gs          , Gs          , Gs          , Gd          , Gs          , Gd          , Gd          , Gs          , Gs          , Gs          , Gd^Vhr      , Gg^Gvs      , Gg^Gvs      , Gs^Eff      , Gs^Eff      , Gs          , Gd          , Gd          , Gs          , Gs          , Gs          , Gs          , Gg          , Gg          , Gg          , Gg          , Gg          , Gg          , Gg          , Gg          , Gg          , Gg          , Gg          , Gg          , Gg          , Re          , Re          , Re^Es       , Re          , Re          , Re          , Mm          , Mm          
Ds          , Ds          , Ds          , Gs          , Gs          , Gd          , Gd          , Gd          , Gd          , Gd          , Gd          , Gs          , Gg          , Gg^Eff      , Gg^Eff      , Gg^Eff      , Gs          , Gs          , Gd          , Gd          , Gd          , Gs          , Gs^Gvs      , Gs^Gvs      , Gs^Gvs      , Gg          , Gg^Gvs      , Gg^Gvs      , Gg^Gvs      , Gg          , Gg          , Gg          , Gg          , Gg^Es       , Gg          , Gg          , Re^Es       , Re          , Re          , Re          , Re          , Re          , Mm          , Mm          , Mm          , Mm          
Ds          , Ds          , Ds          , Gs          , Gd          , Gd          , Gd          , Gd          , Gd          , Gd          , Gd          , Gd          , Gg          , Gg          , Gg          , Gg          , Gs          , Gd          , Gd          , Gd          , Gs          , Gs^Gvs      , Gs^Gvs      , Gs^Gvs      , Gg^Gvs      , Gg^Gvs      , Gg^Gvs      , Gg^Gvs      , Gg^Gvs      , Gg^Gvs      , Gg          , Gg          , Gg^Es       , Gg          , Re          , Re          , Re          , Re          , Gg^Es       , Re          , Mm          , Mm          , Mm          , Mm          , Mm          , Mm          
Ds          , Ds          , Gd          , Gd          , Gd          , Gll^Fp      , Gll^Fp      , Gd          , Gd          , Gg          , Gg          , Gg          , Gg          , Gg          , Gg          , Gs          , Gs          , Gd^Es       , Gs          , Gs          , Gs          , Gs^Gvs      , Gg^Gvs      , Gg^Gvs      , Gg^Gvs      , Gg^Gvs      , Gg^Gvs      , Gg^Gvs      , Gg^Gvs      , Gg^Gvs      , Re          , Re          , Re          , Re          , Gg^Es       , Re          , Gg          , Gg          , Gg          , Gg          , Mm          , Mm          , Mm          , Mm          , Mm          , Mm          
Ds          , Gd          , Gd          , Gd          , Gd          , Gd^Fmw      , Gd          , Gd          , Gd          , Gg          , Gg^Es       , Gg          , Gg          , Gg          , Gd^Fmw      , Gs          , Gs          , Gs          , Gs          , Gs          , Gg          , Gg^Gvs      , Gg^Gvs      , Gg^Gvs      , Gg^Gvs      , Gg^Gvs      , Gg^Gvs      , Gg^Gvs      , Gg^Gvs      , Gg^Gvs      , Re          , Re          , Gg          , Gg          , Gg          , Gg          , Gg          , Gg^Es       , Gg          , Gg^Es       , Hh          , Mm          , Hh          , Mm          , Mm          , Mm          
Gs          , Gs          , Gs          , Gs          , Gs          , Gs          , Cty         , Gd          , Rb          , Gg          , Gg          , Gg          , Gg          , Gd^Fmw      , Gd^Fmw      , Ss          , Gg          , Gs          , Gs          , Gg          , Gg^Gvs      , Gg^Gvs      , Gg^Gvs      , Gg^Gvs      , Gg^Gvs      , Gg^Gvs      , Gg^Gvs      , Gg^Gvs      , Gg          , Re          , Re          , Gg          , Gg          , Gg          , Gg^Efm      , Gg          , Gg          , Gg          , Hh          , Hh          , Hh          , Hh          , Hh          , Mm          , Mm          , Mm          
Gs          , Gs          , Gs          , Gs^Es       , Gg          , Cty         , 2 Kty       , Cty         , Cty         , Cty         , Rb          , Gg          , Gg          , Ss          , Gg          , Ss          , Gg          , Gg          , Gg^Eff      , Gg^Eff      , Gg^Gvs      , Gg^Gvs      , Gg^Gvs      , Gg^Gvs      , Gg^Gvs      , Gg^Gvs      , Gg^Gvs      , Gd^Fdf      , Re          , Re          , Gg          , Gg          , Gg^Efm      , Gg^Efm      , Gg^Efm      , Gg          , Gg          , Gg          , Hh^Fp       , Hh          , Hh^Fp       , Hh          , Hhd^Vhhr    , Hh          , Hh          , Hh          
Gs          , Gs          , Gs          , Gs          , Gs          , Rb          , Gs          , Cty         , Gs          , Rb          , Gs          , Gg^Es       , Gg          , Gg          , Gg          , Gg          , Gg^Eff      , Gg^Eff      , Gg^Gvs      , Gg^Gvs      , Gg^Gvs      , Gg^Gvs      , Gg^Gvs      , Gg^Gvs      , Gg^Gvs      , Gg^Gvs      , Gg^Gvs      , Re          , Re          , Re          , Gg          , Gg          , Gg          , Gg^Efm      , Gg          , Gg          , Gll^Fp      , Gll^Fp      , Gll^Fp      , Gll^Fp      , Hh^Fp       , Hh          , Hh          , Hh^Fp       , Hh^Fp       , Hh          
Gd          , Gs          , Gs          , Ss          , Ss          , Gg          , Gg          , Gs          , Ss          , Gs          , Gd^Fmw      , Gg          , Gg          , Gg          , Gg^Eff      , Gg^Eff      , Gg          , Gg^Gvs      , Gg^Gvs      , Gg^Gvs      , Gg^Gvs      , Gg^Gvs      , Gg^Gvs      , Gg^Gvs      , Gg^Gvs      , Gg^Gvs      , Gg^Gvs      , Re          , Gg          , Gg          , Gg          , Gg          , Gg          , Gg          , Gg          , Gll^Fp      , Gll^Fp      , Gll^Fp      , Hh^Fp       , Gll^Fp      , Hh^Fp       , Hh^Fp       , Hh^Fp       , Hh^Fp       , Hh^Fp       , Hh^Fp       
Gd          , Gd          , Gd          , Gs          , Ss          , Ss          , Ss          , Ss          , Ss          , Ss          , Ss          , Ss          , Ss          , Gg^Eff      , Gg^Eff      , Gg          , Gg^Gvs      , Gg^Gvs      , Gg^Gvs      , Gg^Gvs      , Gg^Gvs      , Gg^Gvs      , Gg^Gvs      , Gg^Gvs      , Gg^Gvs      , Gg^Gvs      , Gd^Vhr      , Re          , Gg          , Ch          , Gg          , Gg          , Gg          , Gg          , Gg          , Gg          , Gg          , Gll^Fp      , Gll^Fp      , Gll^Fp      , Gll^Fp      , Gll^Fp      , Gll^Fp      , Hh^Fp       , Hh^Fp       , Hh^Fp       
Gd          , Gd          , Gs          , Ss          , Ss          , Ss          , Ss          , Ss^Vhs      , Ss          , Ss          , Gg          , Ss          , Ss          , Gg          , Gg          , Gg          , Gg^Gvs      , Gg^Gvs      , Gg^Gvs      , Gg^Gvs      , Gg^Gvs      , Gg^Gvs      , Gg^Gvs      , Gg^Gvs      , Re^Eff      , Re^Eff      , Re          , Re          , Gg          , Gg          , Gg          , Gg          , Gg          , Gg          , Gg^Efm      , Gg          , Gg          , Gg          , Gll^Fp      , Gll^Fp      , Gg          , Gll^Fp      , Gll^Fp      , Gll^Fp      , Gll^Fp      , Hh^Fp       
Gd          , Gd          , Gs          , Ss          , Gs          , Ss          , Ss          , Ss          , Ss          , Ss          , Gg          , Gg          , Gg          , Gg          , Gg          , Gg          , Gg^Gvs      , Gg^Gvs      , Gg^Gvs      , Gg^Gvs      , Gg^Gvs      , Gg^Gvs      , Re^Eff      , Re^Eff      , Gg          , Gg          , Gg          , Gg          , Gg          , Gg          , Gg          , Gd^Fdf      , Gd^Fdf      , Gg^Efm      , Gg^Efm      , Gg^Efm      , Gg          , Gll^Fp      , Gll^Fp      , Gg          , Gg          , Gg          , Gg          , Gg          , Gll^Fp      , Gll^Fp      
Wwg         , Gd          , Gg          , Gs          , Gs          , Gs          , Ss          , Ss          , Ss          , Gg          , Gg          , Gd          , Gd          , Gg          , Gg          , Gg          , Gg^Gvs      , Gg^Gvs      , Gg^Gvs      , Gg^Gvs      , Re^Eff      , Re^Eff      , Gg          , Gg          , Gg          , Gg          , Gg          , Gg          , Gd^Fdf      , Gd^Fdf      , Gd^Fdf      , Gd^Fdf      , Gll^Efm     , Gg^Efm      , Gg^Efm      , Gg^Efm      , Gg          , Gll^Fp      , Gg          , Gg          , Gg          , Gg          , Gg^Ve       , Gg          , Gll^Fp      , Gll^Fp      
Wwg         , Gd          , Gg          , Gg          , Gg          , Ss          , Ss          , Ss          , Gg          , Gg          , Gd          , Gd          , Gd          , Gd          , Gg          , Gg          , Gg          , Gg          , Gd^Fdf      , Re^Eff      , Re          , Re          , Gg          , Gg          , Gg^Gvs      , Gg^Gvs      , Gg^Gvs      , Gd^Fdf      , Gd^Fdf      , Gd^Fdf      , Gd^Fdf      , Gll^Efm     , Gll^Efm     , Gg^Fet      , Gd^Fdf      , Gg^Efm      , Gg^Efm      , Gg          , Gg          , Gg          , Gg          , Gg          , Gg          , Gg          , Gg          , Gll^Fp      
Wwg         , Gs          , Gs          , Gg          , Gs          , Gg          , Ss          , Ss          , Gg          , Gg          , Gd          , Gd          , Gd          , Gd          , Gg          , Gg          , Gg          , Gd^Fdf      , Re          , Re          , Gd^Vhr      , Gg          , Gg^Eff      , Gg^Gvs      , Gg^Gvs      , Gg^Gvs      , Gg^Gvs      , Gg^Gvs      , Gg^Gvs      , Gd^Fdf      , Gd^Fdf      , Gd^Fdf      , Gll^Fmf     , Gll^Fmf     , Gll^Fmf     , Gg^Efm      , Gg          , Gg          , Gg          , Gg          , Gg          , Gg          , Gll^Fp      , Gg          , Gll^Fp      , Gll^Fp      
Wwg         , Wwg         , Wwg         , Gs          , Gs          , Gs          , Ss          , Ss          , Gg          , Gs          , Gd          , Gd          , Gd          , Gd          , Gg          , Gg          , Gg^Eff      , Gg^Eff      , Re          , Re          , Gg          , Gg^Eff      , Gg^Eff      , Gg^Gvs      , Gg^Gvs      , Gg^Gvs      , Gg^Gvs      , Gg^Gvs      , Gd^Fdf      , Gd^Fdf      , Gll^Fmf     , Gll^Fmf     , Gll^Fmf     , Gll^Fmf     , Gll^Fmf     , Gll^Fp      , Gll^Fp      , Gll^Fp      , Gll^Fp      , Gll^Fp      , Gll^Fp      , Gll^Fp      , Gll^Fp      , Gll^Fp      , Gll^Fmf     , Gll^Fp      
Wwg         , Wwg         , Wwg         , Ss          , Ss          , Ss          , Ss          , Ss          , Gg          , Gs          , Gs          , Gd          , Gd          , Gd          , Gg          , Gg^Eff      , Gg^Gvs      , Gg^Gvs      , Gg^Gvs      , Re          , Re          , Gg^Eff      , Gg^Eff      , Gg^Gvs      , Gg^Gvs      , Gg^Gvs      , Gg^Gvs      , Gg^Gvs      , Gd^Fdf      , Gd^Fdf      , Gll^Fmf     , Gll^Fmf     , Gd^Fdf      , Gll^Fmf     , Gll^Fmf     , Gll^Fp      , Gg          , Gll^Fp      , Gll^Fp      , Gll^Fmf     , Gll^Fmf     , Gll^Fp      , Gll^Fmf     , Gll^Fp      , Gll^Fmf     , Gll^Fmf     
Wwg         , Wwg         , Ss          , Ss          , Ss          , Ss          , Gg          , Gg          , Gs          , Gs          , Gs          , Gg          , Gg          , Gg          , Gg          , Gg          , Gg          , Gg^Gvs      , Gg^Gvs      , Gg^Gvs      , Gg^Gvs      , Gg          , Gg          , Gg^Eff      , Gg^Eff      , Gg^Gvs      , Gg^Gvs      , Gg^Gvs      , Gd^Gvs      , Gd^Fdf      , Gd^Fdf      , Gd^Fdf      , Gd^Fdf      , Gd^Fdf      , Gd^Fdf      , Gll^Fmf     , Gg          , Gg          , Gg          , Gg          , Gd^Fdf      , Gll^Fmf     , Gd^Fdf      , Gll^Fmf     , Gll^Fmf     , Gll^Fmf     
Ss          , Ss          , Ss          , Ss          , Gg          , Gg          , Gg          , Gs          , Gs          , Gs          , Gg          , Gg          , Gg          , Gg          , Gg          , Gg          , Gg          , Gg^Gvs      , Gg^Gvs      , Gg^Gvs      , Gg^Gvs      , Gg^Gvs      , Re          , Gg^Eff      , Gg^Eff      , Gg^Gvs      , Gg^Gvs      , Gg^Gvs      , Gg^Gvs      , Gd^Fdf      , Gd^Fdf      , Gd^Fdf      , Gg          , Gg          , Ce          , Gd^Fdf      , Gg          , Gg          , Gg          , Gg          , Gg          , Gd^Fdf      , Gg          , Gll^Fmf     , Gll^Fmf     , Gll^Fmf     
Wwg         , Ss          , Wwg         , Wwg         , Gg          , Gs          , Gg          , Gg^Es       , Gg          , Gg          , Gg          , Gg          , Gg          , Ss          , Ss          , Gg          , Gg          , Gg^Gvs      , Gg^Gvs      , Gg^Gvs      , Gg^Gvs      , Gg^Gvs      , Re          , Gg          , Gg          , Gg^Eff      , Gg          , Gg          , Gg          , Gd^Fdf      , Gd^Fdf      , Gd^Fdf      , Ce          , 4 Ke        , Ce          , Ce          , Gg          , Gg          , Gg          , Gg          , Gg          , Gd^Fdf      , Gd^Fdf      , Gd^Fdf      , Gd^Fdf      , Gll^Fmf     
Wwg         , Wwg         , Gg          , Gg          , Gs          , Gs          , Gg          , Gg          , Gg          , Gg          , Ss          , Gg          , Gg          , Gg          , Gg          , Gg          , Gg          , Gg^Gvs      , Gg^Gvs      , Gg^Gvs      , Gg^Gvs      , Gg^Gvs      , Re          , Gg          , Gd^Fdf      , Gg          , Gg          , Gg          , Gg          , Gd^Fdf      , Gg          , Gd^Fdf      , Ce          , Ce          , Gg^Efm      , Gg^Efm      , Gg^Efm      , Gg          , Gg          , Gg          , Gg          , Gd^Fdf      , Gg          , Gd^Fdf      , Gd^Fdf      , Gd^Fdf      
Ss          , Gg          , Gs          , Gs          , Gs          , Gs          , Gg          , Gg          , Ss          , Ss          , Ss          , Gg          , Gg          , Gg          , Ss          , Gg          , Gg          , Gg^Gvs      , Gg^Gvs      , Gg^Gvs      , Gg^Gvs      , Gg^Gvs      , Re          , Gg          , Gg^Es       , Gg          , Gg          , Gg          , Gd^Vhr      , Gg          , Gg          , Gg          , Gg          , Gg          , Gg^Efm      , Gg^Efm      , Gg^Efm      , Gg          , Gd^Fdf      , Gg          , Gg          , Gg          , Gg          , Gg          , Gg          , Gd^Fdf      
Ss          , Gg          , Gg          , Gs          , Gg          , Gg          , Gg          , Gg          , Ss          , Ss          , Gg          , Gg          , Ss          , Ss          , Ss          , Gg          , Gg          , Gg^Gvs      , Gg^Gvs      , Gg^Gvs      , Re^Eff      , Re^Eff      , Gg          , Gg          , Gg          , Gg          , Gg          , Gg          , Gg          , Gg          , Gg          , Gg          , Gg          , Gg          , Gg          , Gg^Efm      , Gg^Efm      , Gg          , Gg          , Gg          , Gg^Efm      , Gg          , Gg          , Gg^Ve       , Gg          , Gg          
Ss          , Ss          , Ss          , Gg          , Ss          , Gg          , Ss          , Ss          , Ss          , Ss          , Ss          , Ss          , Gg          , Ss          , Gg          , Gg          , Gg          , Gg^Gvs      , Gg^Eff      , Gg^Eff      , Re          , Re          , Gg          , Gg          , Gg          , Gg          , Gg          , Gg          , Gg          , Gg          , Gg          , Gg          , Gg          , Gg          , Gg          , Gg          , Gg          , Gg          , Gg          , Gg          , Gg^Efm      , Gg^Fet      , Gg^Efm      , Gg          , Gd^Fdf      , Gd^Fdf      
Ss          , Ss          , Ss          , Ss          , Ss          , Ss          , Ss          , Ss^Vhs      , Ss          , Ss          , Gg          , Gg          , Gg          , Gg          , Gg          , Gg          , Gg          , Gg^Eff      , Gg          , Re          , Re          , Gg          , Gg          , Gg          , Gd^Fdf      , Gg          , Gd^Fdf      , Gd^Fdf      , Gd^Fdf      , Gg          , Gg          , Gg          , Gg          , Gg          , Gg          , Gg          , Gg          , Gg          , Gg          , Gg^Efm      , Gg^Efm      , Gg^Efm      , Gg          , Gg          , Gd^Fdf      , Gll^Fmf     
Wwg         , Ss          , Ss          , Ss          , Wwg         , Wwg         , Ss          , Ss          , Gg          , Ss          , Ss          , Ss          , Gg          , Gg          , Gg          , Gd^Fdf      , Gg          , Gg          , Re          , Re          , Gg          , Gg          , Gg          , Gg          , Gd^Fdf      , Gd^Fdf      , Gd^Fdf      , Gd^Fdf      , Gd^Fdf      , Gg          , Gg          , Gg          , Gg          , Gg          , Gg          , Gg          , Gg          , Gg          , Gg          , Gg          , Gg          , Gg          , Gd^Fdf      , Gd^Fdf      , Gll^Fmf     , Gll^Fmf     
Wwg         , Wwg         , Wwg         , Wwg         , Ss          , Ss          , Ss          , Gg          , Gg          , Gg          , Ss          , Gg          , Ss          , Gg          , Gg          , Gg          , Re          , Gg          , Gg          , Gg          , Re          , Gg          , Gg          , Gg          , Gg          , Gd^Fdf      , Gg          , Gd^Fdf      , Gg          , Gg          , Gg          , Gg          , Gg          , Gg          , Gg          , Gg          , Gg          , Gg          , Gg          , Gg          , Gd^Fdf      , Gd^Fdf      , Gll^Fmf     , Gll^Fmf     , Gll^Fmf     , Gll^Fmf     
Wwg         , Wwg         , Wwg         , Wwg         , Ss          , Ss          , Gg          , Gg          , Gg          , Ss          , Gg          , Ss          , Ss          , Gg          , Gg          , Gg          , Re          , Gg          , Gg          , Gg          , Re          , Gg          , Gg^Es       , Gg          , Gg          , Gg          , Gg          , Gg          , Gg          , Gg          , Gg          , Gg          , Gg          , Gg          , Gg          , Gg          , Gg^Efm      , Gg          , Gg          , Gg          , Gd^Fdf      , Gll^Fmf     , Gll^Fp      , Gll^Fp      , Gll^Fp      , Gll^Fp      
Wwg         , Wwg         , Ss          , Ss          , Ss          , Gg          , Gg          , Gg          , Gg          , Gg          , Gg          , Gg          , Gg          , Gg          , Gg          , Gg          , Gg          , Re          , Gg          , Gg          , Re          , Gg          , Gg          , Gg          , Gg          , Gg          , Gg          , Gd^Fdf      , Gd^Fdf      , Gg          , Gg          , Gg          , Gg          , Gg          , Gg          , Gg^Efm      , Gg^Fet      , Gg^Efm      , Gg          , Gg          , Gd^Fdf      , Gll^Fmf     , Gll^Fp      , Gll^Fp      , Gll^Fmf     , Gll^Fp      
Ss          , Ss          , Ss          , Ss          , Gg          , Gg          , Ss          , Gg          , Ss          , Gg          , Gg          , Gg^Es       , Gg          , Gg          , Gg          , Gg          , Re          , Gg          , Re          , Re          , Re          , Re          , Re          , Gg          , Gg          , Gg          , Gd^Fdf      , Gd^Fdf      , Gll^Fmf     , Gd^Fdf      , Gd^Fdf      , Gg          , Gg          , Gg          , Gg          , Gg^Efm      , Gg^Efm      , Gg^Efm      , Gg^Efm      , Gg          , Gd^Fdf      , Gll^Fmf     , Gll^Fmf     , Gll^Fmf     , Gll^Fmf     , Gll^Fp      
Ss          , Ss          , Ss          , Ss          , Ss          , Ss          , Ss          , Ss          , Gg          , Gg          , Gg          , Gg          , Gg          , Gg          , Re          , Re          , Gg          , Re          , Gg          , Gd^Vhr      , Re          , Re          , Gg          , Gg          , Gg          , Gd^Fdf      , Gd^Fdf      , Gll^Fmf     , Gd^Fdf      , Gll^Fmf     , Gd^Fdf      , Gg          , Gg          , Gg          , Gg          , Gg          , Gg          , Gg^Efm      , Gg          , Gg          , Gg          , Gd^Fdf      , Gd^Fdf      , Gll^Fmf     , Gll^Fmf     , Gll^Fmf     
Ss          , Ss          , Wwg         , Ss          , Ss          , Ss          , Gg          , Gg          , Gg          , Gg          , Gg          , Gg          , Re          , Re          , Gg          , Gg          , Gg          , Gg          , Gg          , Re          , Re          , Re          , Gg          , Gg          , Gg          , Gg          , Gd^Fdf      , Gd^Fdf      , Gd^Fdf      , Gd^Fdf      , Gg          , Gg          , Gg          , Gg          , Gg          , Gg          , Gd^Fdf      , Gg          , Gg          , Gg          , Gg          , Gd^Fdf      , Gd^Fdf      , Gd^Fdf      , Gll^Fmf     , Gll^Fmf     
Wwg         , Wwg         , Wwg         , Wwg         , Ss          , Gg          , Gg          , Gg          , Ce          , 3 Ke        , Ce          , Re          , Gg          , Gg          , Gg          , Gg          , Gg^Es       , Gg          , Gg          , Re          , Rp          , Rp          , Gg          , Gg          , Gg          , Gg          , Gg          , Gd^Fdf      , Gd^Fdf      , Gg          , Gg          , Gg          , Gg          , Gg          , Gd^Fdf      , Gd^Fdf      , Gd^Fdf      , Gd^Fdf      , Gg          , Gg          , Gg          , Gg          , Gd^Fdf      , Gd^Fdf      , Gd^Fdf      , Gll^Fmf     
Wwg         , Ss          , Ss          , Ss          , Ss          , Gg          , Gg          , Gg          , Ce          , Ce          , Ce          , Re          , Gg          , Gg          , Gg          , Gg          , Gg          , Gg          , Gg          , Re          , Rp          , Gd^Vhr      , Gg          , Gg          , Gg          , Gg          , Gg          , Gg          , Gg          , Gg          , Gg          , Gg          , Gg          , Gg          , Gd^Fdf      , Gll^Fmf     , Gll^Fmf     , Gll^Fmf     , Gg          , Gg          , Gg          , Gd^Fdf      , Gd^Fdf      , Gd^Fdf      , Gll^Fmf     , Gd^Fdf      
Wwg         , Wwg         , Ss          , Ss          , Ss          , Gg          , Gg          , Gg          , Gg          , Gg          , Re          , Re          , Gg          , Gg          , Gg          , Gg          , Gg          , Gg          , Gg          , Gg          , Re          , Rp          , Gg          , Gg^Efm      , Gg^Efm      , Gg          , Gg          , Gg          , Gg          , Gg          , Gg          , Gg          , Gg          , Gg          , Gd^Fdf      , Gll^Fp      , Gll^Fmf     , Gll^Fmf     , Gll^Fmf     , Gg          , Gg^Ve       , Gg          , Gd^Fdf      , Gll^Fmf     , Gll^Fmf     , Gll^Fmf     
Wwg         , Wwg         , Wwg         , Ss          , Wwg         , Ss          , Ss          , Rb          , Rb          , Re          , Rb          , Gg          , Ss          , Ss          , Ss          , Ss          , Ss          , Gg          , Ss          , Gg          , Rp          , Rp          , Gg          , Gg          , Gg          , Gg          , Gg          , Gg          , Gg          , Gg          , Gg          , Gg          , Gg          , Gd^Fdf      , Gll^Fmf     , Gll^Fp      , Gll^Fp      , Gll^Fmf     , Gll^Fmf     , Gg          , Gg          , Gg          , Gd^Fdf      , Gll^Fmf     , Gll^Fmf     , Gll^Fmf     
Wwg         , Wwg         , Wwg         , Wwg         , Ss          , Wwg         , Ss          , Ss          , Ss^Bw/      , Rb          , Rb          , Ss          , Ss          , Ss          , Ss          , Ss          , Ss          , Ss          , Rp          , Ss^Bw/      , Ss          , Ss          , Ss          , Ss          , Ss          , Gg          , Gg          , Gg          , Gg          , Gg          , Gg          , Gd^Fdf      , Gg          , Gd^Fdf      , Gll^Fmf     , Gll^Fmf     , Gll^Fmf     , Gll^Fp      , Gd^Fdf      , Gd^Fdf      , Gd^Fdf      , Gg          , Gd^Fdf      , Gd^Fdf      , Gll^Fmf     , Gll^Fmf     
Wwg         , Wwg         , Ss          , Ss          , Ss          , Ss          , Rb          , Ss^Bw/      , Ss          , Ss          , Ss          , Ss          , Ss          , Ss          , Gg          , Ss          , Gg          , Gg          , 1 Ke        , Gg          , Gg          , Ss          , Ss          , Ss          , Ss          , Ss          , Ss          , Gg          , Gg          , Gg          , Gg          , Gg          , Gd^Fdf      , Gd^Fdf      , Gd^Fdf      , Gll^Fmf     , Gd^Fdf      , Gd^Fdf      , Gll^Fmf     , Gll^Fmf     , Gll^Fmf     , Gd^Fdf      , Gd^Fdf      , Gd^Fdf      , Gd^Fdf      , Gll^Fmf     
Wwg         , Ss          , Ss          , Ss          , Gg          , Rb          , Re          , Rb          , Gg          , Gg          , Gg          , Gg          , Gg          , Gg          , Gg^Gvs      , Gg          , Rr          , Ce          , Ce          , Ce          , Ce          , Gg          , Ss          , Ss          , Ss          , Ss          , Ss          , Gg          , Gd^Fdf      , Gg          , Gd^Fdf      , Gd^Fdf      , Gll^Fmf     , Gll^Fmf     , Gll^Fmf     , Gd^Fdf      , Gd^Fdf      , Gll^Fmf     , Gll^Fmf     , Gll^Fmf     , Gll^Fmf     , Gd^Fdf      , Gd^Fdf      , Gd^Fdf      , Gd^Fdf      , Gd^Fdf      
Ss          , Ss          , Gg          , Gg          , Rr          , Rr          , Rr          , Gg          , Gg^Gvs      , Gg^Gvs      , Gg^Gvs      , Gg^Gvs      , Gg^Gvs      , Gg^Gvs      , Rr          , Rr          , Rr          , Rr          , Rr          , Gg          , Gg^Gvs      , Gg^Gvs      , Gg^Gvs      , Ss          , Ss          , Gd^Fdf      , Gd^Fdf      , Gd^Fdf      , Gd^Fdf      , Gd^Fdf      , Gd^Fdf      , Gd^Fdf      , Gll^Fmf     , Gll^Fmf     , Gll^Fp      , Gll^Fp      , Gd^Fdf      , Gll^Fmf     , Gll^Fmf     , Gll^Fmf     , Gll^Fmf     , Gd^Fdf      , Gd^Fdf      , Gd^Fdf      , Gd^Fdf      , Gd^Fdf      
