border_size=1
usage=map

Mm^Xm       , Mm^Xm       , Mm^Xm       , Mm^Xm       , Mm^Xm       , Mm^Xm       , Mm^Xm       , Mm^Xm       , Mm^Xm       , Mm          , Mm^Xm       , Mm^Xm       , Mm^Xm       , Mm^Xm       , Mm          , Mm          , Mm          , Mm          , Mm          , Mm          , Mm          , Mm          , Mm          , Mm          , Mm          , Mm          , Mm          , Mm          , Mm          , Mm          , Mm          , Mm          , Mm          , Mm          , Mm          , Mm          , Mm          , Mm          , Mm          , Mm          , Mm          , Mm          , Mm          , Mm          , Mm          , Mm          , Mm          , Mm          , Hh          , Gs          , Gs          , Gs          
Mm^Xm       , Mm^Xm       , Mm^Xm       , Mm^Xm       , Mm^Xm       , Mm^Xm       , Mm^Xm       , Mm^Xm       , Mm^Xm       , Mm^Xm       , Mm^Xm       , Mm^Xm       , Mm^Xm       , Mm^Xm       , Mm          , Mm          , Mm          , Mm          , Mm          , Mm          , Mm          , Mm          , Mm          , Mm          , Mm          , Mm          , Mm          , Mm          , Mm          , Cud         , 2 Kud       , Cud         , Mm          , Mm          , Mm          , Mm          , Mm          , Mm          , Mm          , Mm          , Mm          , Mm          , Mm          , Mm          , Mm          , Mm          , Mm          , Mm          , Hh          , Gs          , Gs          , Gs          
Mm^Xm       , Mm^Xm       , Mm^Xm       , Mm^Xm       , Mm^Xm       , Mm^Xm       , Mm^Xm       , Mm^Xm       , Mm^Xm       , Mm^Xm       , Mm^Xm       , Mm^Xm       , Mm          , Mm          , Mm          , Mm          , Mm          , Mm          , Mm          , Mm          , Mm          , Mm          , Mm          , Mm          , Mm          , Mm          , Mm          , Hh^Vhh      , Mm          , Ce          , Ce          , Ce          , Mm          , Mm^Vhh      , Mm          , Mm          , Mm          , Mm          , Mm          , Mm          , Mm          , Mm          , Mm          , Mm          , Mm          , Mm          , Hh          , Hh          , Hh          , Gs          , Gs          , Gs          
Mm^Xm       , Mm^Xm       , Mm^Xm       , Mm^Xm       , Mm^Xm       , Mm^Xm       , Mm^Xm       , Mm^Xm       , Mm^Xm       , Mm^Xm       , Mm          , Mm          , Mm          , Mm          , Mm          , Mm          , Mm          , Mm          , Mm          , Mm          , Mm          , Mm^Vhh      , Mm          , Mm          , Mm          , Mm          , Hh          , Mm          , Hh          , Mm          , Hh          , Mm          , Hh          , Hh          , Hh          , Mm          , Mm          , Mm          , Hh          , Mm          , Hh          , Mm          , Hh          , Hh          , Hh          , Hh          , Gs          , Gs          , Gs          , Gs          , Gs          , Gs          
Mm^Xm       , Mm^Xm       , Mm^Xm       , Mm^Xm       , Mm^Xm       , Mm^Xm       , Mm^Xm       , Mm^Xm       , Mm          , Mm          , Mm          , Mm          , Mm          , Mm          , Mm          , Mm          , Mm          , Mm          , Mm          , Mm          , Mm          , Mm          , Hh          , Hh          , Hh          , Hh          , Gs          , Hh          , Gs          , Hh          , Hh          , Hh          , Hh          , Hh          , Gs          , Hh          , Hh          , Hh          , Gs          , Hh          , Gs          , Hh          , Gs          , Hh          , Gs          , Gs          , Gs          , Gs          , Gs          , Gs          , Re          , Re          
Mm^Xm       , Mm^Xm       , Mm^Xm       , Mm^Xm       , Mm          , Mm^Xm       , Mm          , Mm          , Mm          , Mm          , Mm          , Mm          , Mm          , Mm          , Mm          , Mm          , Mm          , Mm^Vhh      , Mm          , Mm          , Hh          , Hh          , Hh          , Hh          , Hh          , Hh          , Mm          , Gs          , Gs          , Gs          , Gll^Fp      , Hh^Fp       , Gs          , Gs          , Gs          , Gs          , Gs          , Gs          , Gd          , Gd          , Gd          , Gd          , Gd          , Gs          , Gs          , Gs          , Gs          , Gs          , Gs          , Re          , Gs          , Gs          
Mm^Xm       , Mm^Xm       , Mm          , Mm          , Mm          , Mm          , Mm          , Mm          , Mm          , Mm          , Mm          , Mm          , Mm          , Mm          , Hh          , Mm          , Mm          , Mm          , Hh          , Hh          , Hh          , Hh          , Gs          , Gs          , Gs          , Mm          , Mm          , Mm          , Gs          , Gs          , Gll^Fp      , Gll^Fp      , Gll^Fp      , Gs          , Gs          , Gs          , Gs          , Gd          , Gd          , Gd          , Gd          , Gs          , Gd          , Gs          , Gs^Vc       , Gs          , Gs          , Gs          , Re          , Gs          , Re          , Gs          
Mm          , Mm          , Mm          , Mm          , Mm          , Mm          , Mm          , Mm          , Mm          , Mm          , Mm          , Mm          , Mm          , Hh          , Gs          , Hh          , Hh          , Hh          , Gs          , Hh          , Gs          , Gs          , Hh          , Hh          , Gs          , Hh          , Hh          , Hh          , Gs          , Gs          , Gs          , Gll^Fp      , Gs          , Gs          , Gs          , Gg          , Gg          , Gd          , Gs          , Gd          , Gd          , Gd          , Gs          , Gs          , Gs          , Gs          , Gs          , Re          , Re          , Re          , Re          , Re          
Mm          , Mm          , Mm          , Mm          , Mm          , Mm          , Mm          , Mm          , Mm          , Mm          , Mm          , Mm          , Mm          , Hh          , Gs          , Gg          , Ww          , Gs          , Hh          , Hh          , Hh          , Hh          , Mm          , Hh          , Hh          , Gs          , Gs          , Gs          , Gs          , Gs          , Gs          , Gll^Fp      , Gs          , Gs          , Gg          , Gg          , Gg^Es       , Gs          , Gs          , Gs          , Gs          , Gs          , Gs          , Gs          , Gs          , Gs          , Re          , Re          , Gs          , Gs          , Gs          , Gs          
Mm          , Mm          , Mm          , Mm          , Mm          , Mm          , Mm          , Mm          , Mm          , Mm          , Mm          , Mm          , Mm          , Hh          , Gs          , Gg          , Gg          , Gg          , Hh          , Hh          , Mm          , Mm          , Mm          , Hh          , Hh          , Gs          , Gs          , Gs          , Gs          , Gs          , Gll^Fp      , Gs          , Gs          , Gg          , Gg          , Gg          , Gs          , Gs          , Gs          , Gs          , Gs          , Gs          , Qxe         , Gs          , Gs          , Re^Es       , Gs          , Gs          , Gs          , Gs          , Re          , Gs          
Mm          , Mm          , Mm          , Mm          , Mm          , Mm          , Mm          , Mm          , Hh          , Mm          , Mm          , Mm          , Mm          , Hh          , Hh          , Gs          , Hh          , Hh          , Mm          , Mm          , Mm          , Mm          , Mm          , Hh          , Hh^Fp       , Gll^Fp      , Gll^Fp      , Gs          , Gs          , Gs          , Gs          , Gs          , Gs          , Gg          , Gs          , Gg          , Gs          , Gs          , Gs          , Gs          , Qxe         , Qxe         , Gs          , Gs          , Gs          , Re          , Re          , Gs          , Re          , Gs          , Gs          , Gs          
Mm          , Mm          , Mm          , Mm          , Mm          , Mm          , Mm          , Hh          , Mm          , Hh          , Hh          , Mm          , Mm          , Mm          , Hh          , Hh          , Mm          , Mm          , Mm          , Mm          , Mm          , Mm          , Hh          , Hh          , Hh^Fp       , Gll^Fp      , Gll^Fp      , Gll^Fp      , Gs          , Gs          , Gs          , Gs          , Gs          , Gs          , Qxe         , Gs          , Qxe         , Qxe         , Qxe         , Qxe         , Gs          , Gs          , Gd          , Gd          , Gd          , Gd          , Re          , Gs          , Gs          , Gs          , Gs          , Gs          
Mm          , Mm          , Mm          , Mm          , Mm          , Mm          , Hh          , Mm          , Mm          , Mm          , Hh          , Mm          , Mm          , Mm          , Hh          , Hh          , Hh          , Mm          , Mm          , Mm          , Mm          , Mm          , Hh          , Hh          , Gll^Fp      , Gll^Fp      , Gll^Fp      , Gll^Fp      , Gs          , Gs          , Gs          , Gs          , Qxe         , Qxe         , Qxe         , Qxe         , Qxe         , Qxe         , Gs          , Gs          , Re          , Gd          , Gd          , Gd          , Re^Es       , Re          , Gs          , Gs          , Gs          , Gs^Vc       , Gs          , Gs          
Mm          , Mm          , Mm          , Mm          , Hh          , Hh          , Hh          , Hh          , Hh          , Hh          , Hh          , Hh          , Hh          , Hh          , Gs          , Gs          , Gs          , Hh          , Hh          , Hh          , Hh          , Hh          , Gs          , Gs          , Gg          , Gs          , Gs          , Gs          , Re          , Gs          , Qxe         , Qxe         , Qxe         , Qxe         , Qxe         , Qxe         , Gs          , Gs          , Gs          , Gs          , Re          , Gs          , Rp          , Re          , Re          , Re          , Gs          , Gs          , Hh          , Gs          , Gs          , Gs          
Mm          , Mm          , Mm          , Hh          , Hh          , Hh          , Hh^Fp       , Hh^Fp       , Gll^Fp      , Gs          , Gs          , Hh          , Hh^Fp       , Hh          , Gs          , Gs          , Gs^Es       , Gs          , Hh          , Hh          , Hh          , Gs          , Gs          , Gg          , Gg          , Gg          , Re^Es       , Re          , Gd          , Gs          , Qxe         , Qxe         , Qxe         , Qxe         , Gs          , Gs          , Gs          , Gs          , Gs          , Re          , Rp          , Re          , Re          , Re          , Gs          , Gs          , Gs          , Hh          , Gs          , Gs          , Gs          , Gs          
Mm          , Mm          , Mm          , Hh          , Mm          , Hh          , Hh          , Hh^Fp       , Gs^Fp       , Gs^Fp       , Gs          , Gs          , Gll^Fp      , Gs^Fp       , Gs          , Gs          , Gs          , Gs          , Hh          , Hh          , Gs          , Gs          , Gs          , Gs          , Gd          , Gs          , Gd          , Gd          , Qxe         , Qxe         , Qxe         , Qxe         , Qxe         , Gs          , Gd          , Gd          , Gs          , Gs          , Gs          , Re          , Re          , Re          , Gs          , Gs          , Gs          , Gs          , Gs          , Gs          , Gs          , Gs          , Gs          , Gs          
Mm          , Mm          , Hh          , Hh          , Mm          , Mm          , Hh          , Hh          , Gg          , Gs^Fp       , Gs          , Gg          , Gg          , Gs^Fp       , Gs          , Gs          , Gs          , Gs          , Gs          , Hh          , Gs          , Gs          , Hh          , Gd          , Gd          , Re          , Gd          , Qxe         , Qxe         , Qxe         , Mm          , Hh          , Chr         , Khr         , Chr         , Gd          , Gd          , Gs          , Re          , Re          , Gs          , Gs          , Gs          , Gs          , Gs          , Gs^Es       , Gs          , Gs          , Gs          , Gs          , Gs          , Hh          
Hh          , Hh          , Hh          , Hh          , Hh          , Hh          , Hh          , Gg          , Gs          , Gs          , Gs          , Gs          , Hh          , Gg          , Hh          , Gs          , Gg          , Gs          , Gs          , Gs          , Gd          , Gs          , Hh          , Hh          , Hh          , Gd          , Gd          , Qxe         , Mm          , Mm          , Mm          , Mm          , Hh          , Chr         , Gs          , Gd          , Gs          , Gs          , Re^Es       , Gs          , Gs          , Gs          , Hh          , Hh          , Hh          , Hh          , Hh          , Hh          , Gs          , Gs          , Gs          , Hh          
Hh          , Hh          , Hh          , Hh          , Hh          , Hh          , Gg          , Gs          , Gg          , Gg          , Hh          , Hh          , Mm          , Hh          , Gs          , Gs          , Gs          , Gs          , Gs          , Gs          , Gd          , Gd          , Gd          , Hh          , Hh          , Re          , Gd          , Qxe         , Hh          , Mm          , Mm          , Mm          , Re          , Gs          , Rp          , Gs          , Re          , Re          , Re          , Gs          , Gs          , Hh          , Mm          , Mm          , Mm          , Hh          , Gs          , Gs          , Gs          , Gs          , Hh          , Hh          
Gs          , Hh          , Gg          , Hh          , Hh^Vc       , Hh          , Mm          , Gg          , Mm          , Hh          , Hh          , Mm          , Mm          , Mm          , Hh          , Gs          , Gs          , Gs          , Qxe         , Qxe         , Qxe         , Gd          , Gd          , Gd          , Gs^Vc       , Re          , Gs          , Gs          , Gs          , Hh          , Re          , Re          , Gs          , Re          , Gs          , Re          , Gs          , Gs          , Gs          , Gs          , Hh          , Hh          , Mm          , Mm          , Mm          , Hh          , Gs          , Gs          , Gs          , Gs          , Hh          , Mm          
Gs          , Gg          , Gg          , Gg          , Hh          , Hh          , Mm          , Mm          , Mm          , Hh          , Hh          , Hh          , Hh          , Hh          , Gg          , Gs          , Gs          , Qxe         , Qxe         , Qxe         , Qxe         , Qxe         , Gs          , Gs          , Gs          , Re          , Gs          , Gs          , Rp          , Re          , Gs          , Gs          , Gg          , Gs          , Gs          , Gs          , Hh          , Gs          , Gs          , Gs          , Hh          , Hh          , Hh          , Mm          , Hh          , Hh          , Gs          , Gs          , Hh          , Hh          , Mm          , Mm          
Gs          , Gs          , Hh          , Hh          , Mm          , Mm          , Hh          , Hh          , Gg          , Gg          , Gll^Fp      , Hh^Fp       , Gll^Fp      , Gs          , Gs          , Gs          , Qxe         , Qxe         , Qxe         , Qxe         , Qxe         , Qxe         , Gs          , Gs^Es       , Gs          , Gs          , Gs          , Re          , Re          , Re          , Gs          , Gg          , Gg^Es       , Gg          , Hh          , Hh          , Hh          , Hh          , Gs          , Gs          , Gs          , Hh          , Gs          , Hh          , Hh          , Hh          , Gs          , Gs          , Hh          , Hh          , Mm          , Mm          
Gg          , Gg          , Gg          , Hh          , Hh          , Hh          , Gg          , Gs          , Gs^Es       , Gg          , Gs          , Gll^Fp      , Gs          , Gs          , Qxe         , Qxe         , Qxe         , Qxe         , Qxe         , Qxe         , Qxe         , Gs          , Gs          , Gs          , Re          , Re          , Gs          , Gs          , Gs          , Gs          , Gs          , Gs          , Gs          , Gs          , Hh          , Hh          , Mm          , Hh          , Hh          , Gs          , Gs          , Gs          , Gs          , Gs          , Gs          , Gd^Vo       , Gs          , Gs          , Hh          , Hh          , Mm          , Mm          
Gg          , Ce          , Ce          , Gg          , Gg          , Hh          , Gd          , Gs          , Gd          , Gs          , Gs          , Gs          , Gs          , Qxe         , Qxe         , Qxe         , Qxe         , Qxe         , Gs          , Qxe         , Gs          , Qxe         , Gs          , Gs          , Re          , Gs          , Gs          , Hh          , Gs          , Gs          , Gs          , Gs          , Mm          , Mm          , Mm          , Hh          , Mm          , Mm          , Mm          , Gs          , Gs          , Gs          , Gs          , Gs          , Gs          , Gs          , Gs          , Hh          , Mm          , Mm          , Mm          , Mm          
Gg          , Gg          , 1 Ke        , Ce          , Gg          , Gg^Es       , Gd          , Gd          , Gd          , Gs          , Hh          , Gs          , Gg          , Gs          , Gg          , Gs          , Gs          , Gs          , Gs          , Gs          , Qxe         , Qxe         , Gs          , Gs          , Re          , Gs          , Gs          , Gs          , Hh          , Hh          , Hh          , Hh          , Mm          , Mm          , Mm          , Mm          , Mm          , Mm          , Mm          , Hh          , Hh          , Gs          , Gs          , Gs          , Hh          , Gs          , Hh          , Hh          , Mm          , Mm          , Mm          , Mm          
Gg          , Gg          , Ce          , Ce          , Gd          , Gd          , Gd          , Gd          , Hh          , Hh          , Hh          , Hh          , Hh          , Gs          , Gs          , Gs          , Re          , Re          , Gs          , Gs          , Gs          , Gs          , Gs          , Gs          , Re          , Gs          , Gs          , Gll^Fp      , Hh^Fp       , Hh          , Hh          , Hh          , Hh          , Hh          , Hh          , Hh          , Hh          , Hh^Vo       , Hh          , Mm          , Mm          , Hh          , Hh          , Gs          , Hh          , Hh          , Mm          , Mm          , Mm          , Mm          , Mm          , Mm          
Gg          , Ce          , Gd          , Gd          , Gd          , Gd          , Gg          , Gg          , Re          , Hh          , Re          , Hh          , Re          , Gg          , Re          , Re^Es       , Re          , Gs          , Re          , Gs          , Re          , Gs          , Re          , Re          , Re          , Gs          , Gs          , Gll^Fp      , Gll^Fp      , Hh^Fp       , Gll^Fp      , Gs          , Gs          , Gs          , Gs          , Gs          , Co          , Gs          , Hh          , Mm          , Mm          , Mm          , Mm          , Hh          , Mm          , Mm          , Mm          , Mm          , Mm          , Mm          , Mm          , Mm          
Gg          , Ce          , Gg          , Gd          , Re          , Re          , Re          , Re          , Re          , Re          , Gs          , Re          , Gg          , Re          , Gg          , Re          , Gs^Es       , Re          , Gs          , Re          , Gs          , Re^Es       , Gs          , Gs          , Re          , Re          , Re          , Gs          , Gs          , Gll^Fp      , Gs          , Gs          , Gs          , Gd^Vo       , Gs          , Co          , 5 Ko        , Co          , Hh          , Hh          , Mm          , Mm          , Mm          , Mm          , Mm          , Mm          , Mm          , Mm          , Mm          , Mm          , Mm          , Mm          
Gg          , Ce          , Ce          , Re          , Re          , Re^Es       , Re          , Gs          , Gs          , Gs          , Gg          , Gs          , Gs          , Gg          , Gg          , Gg          , Gg          , Gs          , Gs          , Gs          , Gs          , Gs          , Gs          , Gs          , Gs          , Gs          , Gs^Es       , Re          , Re          , Re          , Re          , Re          , Re          , Gs          , Re          , Co          , Co          , Co          , Hh          , Hh          , Mm          , Mm          , Mm          , Mm          , Mm          , Mm          , Mm          , Mm          , Mm          , Mm          , Mm          , Mm          
Re          , Re          , Re          , 3 Ke        , Re          , Re          , Gg          , Gs          , Gs          , Gs^Vc       , Gs          , Gd          , Gd          , Re          , Gg          , Gg          , Gg          , Gs          , Hh          , Hh          , Gs          , Gs          , Gs          , Gs          , Gs          , Gg          , Gs          , Gs          , Gs          , Gs          , Gs^Vo       , Gs          , Co          , Re          , Gs          , Gs          , Gs          , Gs          , Hh          , Hh          , Mm          , Mm          , Mm          , Mm          , Mm          , Mm          , Mm          , Mm          , Mm          , Mm          , Mm          , Mm          
Gs          , Re          , Gg          , Ce          , Gg          , Gs          , Gg          , Gs          , Gs^Es       , Gs          , Gd          , Gd          , Gs          , Gs          , Gs          , Hh          , Gs          , Gs          , Hh          , Hh          , Gs          , Gg          , Gg          , Gg^Es       , Gg          , Gs          , Gs          , Gs          , Gs          , Gs          , Gs          , Gs          , Hh          , Hh          , Hh          , Hh          , Hh          , Hh          , Hh          , Hh          , Mm          , Mm          , Mm          , Mm          , Mm          , Mm          , Mm          , Mm          , Mm          , Mm          , Mm^Xm       , Mm^Xm       
Gs          , 4 Gg        , Gll^Fp      , Gg          , Gll^Fp      , Gg          , Gll^Fp      , Gg          , Gg          , Gs          , Hh          , Gs          , Hh          , Hh          , Hh          , Gs          , Hh          , Gs          , Hh          , Hh          , Hh          , Gs          , Gg          , Gg          , Hh          , Gs          , Hh          , Gs          , Hh          , Gs          , Hh          , Hh          , Hh          , Hh          , Hh          , Hh          , Hh          , Hh^Vo       , Hh          , Hh          , Mm          , Mm          , Mm          , Mm          , Mm          , Mm          , Mm          , Mm          , Mm^Xm       , Mm^Xm       , Mm^Xm       , Mm^Xm       
Gs          , Gg          , Gg          , Gg          , Gll^Fp      , Gll^Fp      , Gll^Fp      , Gg          , Hh          , Hh          , Hh          , Hh          , Mm          , Mm          , Mm          , Hh          , Hh          , Hh          , Hh          , Hh          , Hh          , Hh          , Hh          , Hh          , Hh          , Hh          , Hh          , Hh          , Hh          , Hh          , Hh          , Hh          , Mm          , Hh          , Mm          , Hh          , Mm          , Hh          , Mm          , Mm          , Mm          , Mm          , Mm          , Mm          , Mm          , Mm          , Mm^Xm       , Mm^Xm       , Mm^Xm       , Mm^Xm       , Mm^Xm       , Mm^Xm       
Gg          , Gs          , Gs          , Gs          , Hh          , Hh^Fp       , Hh          , Hh          , Mm          , Mm          , Mm          , Mm          , Mm          , Mm          , Mm          , Mm          , Mm          , Mm          , Mm          , Hh          , Mm          , Mm          , Mm          , Mm          , Mm          , Mm          , Mm          , Mm          , Mm          , Mm          , Mm          , Mm          , Mm          , Mm          , Mm          , Mm          , Mm          , Mm          , Mm          , Mm          , Mm          , Mm          , Mm          , Mm          , Mm^Xm       , Mm^Xm       , Mm^Xm       , 6 Mm^Xm     , Mm^Xm       , Mm^Xm       , Mm^Xm       , Mm^Xm       
Hh          , Hh          , Hh          , Hh          , Mm          , Hh          , Mm          , Mm          , Mm          , Mm          , Mm^Xm       , Mm          , Mm^Xm       , Mm          , Mm^Xm       , Mm          , Mm          , Mm          , Mm          , Mm          , Mm          , Mm          , Mm          , Mm          , Mm          , Mm          , Mm          , Mm          , Mm          , Mm          , Mm          , Mm          , Mm          , Mm          , Mm          , Mm          , Mm          , Mm          , Mm          , Mm          , Mm          , Mm          , Mm          , Mm^Xm       , Mm^Xm       , Mm^Xm       , Mm^Xm       , Mm^Xm       , Mm^Xm       , Mm^Xm       , Mm^Xm       , Mm^Xm       
Hh          , Hh          , Hh          , Hh          , Hh          , Hh          , Mm          , Mm          , Mm          , Mm          , Mm          , Mm^Xm       , Mm^Xm       , Mm^Xm       , Mm^Xm       , Mm^Xm       , Mm^Xm       , Mm          , Mm          , Mm          , Mm          , Mm          , Mm          , Mm          , Mm          , Mm          , Mm          , Mm          , Mm          , Mm          , Mm          , Mm          , Mm          , Mm          , Mm          , Mm          , Mm          , Mm          , Mm          , Mm          , Mm          , Mm          , Mm          , Mm^Xm       , Mm^Xm       , Mm^Xm       , Mm^Xm       , Mm^Xm       , Mm^Xm       , Mm^Xm       , Mm^Xm       , Mm^Xm       
