border_size=1
usage=map

Ds          , Ds          , Ds          , Ds          , Ds          , Ds          , Ds          , Ds          , Ds          , Ds          , Ds          , Ds          , Ds          , Ds          , Ds          , Ds          , Ds          , Ds          , Ds          , Ds          , Ds          , Ds          , Ds          , Ds          , Ds          , Ds          , Ds          , Ds          , Ds          , Ds          , Ds          , Qxua        , Qxua        , Qxua        , Qxua        , Qxua        , Qxua        , Qxua        , Qxua        , Qxua        , Ds          , Ds          , Ds          , Ds          , Ds          , Ds          
Ds          , Ds          , Ds          , Ds          , Rd          , Ds          , Rd          , Rd          , Rd          , Rd          , Rd          , Rd          , Rd          , Rd          , Re          , Ds          , Ds          , Qxua        , Qxua        , Ds          , Ds          , Ds          , Rd          , Ds          , Ds          , Qxua        , Qxua        , Ds          , Ds          , Uh          , Uh          , Ds          , Ds          , Ds          , Ds          , Qxua        , Ds          , Qxua        , Qxua        , Qxua        , Ds          , Ds          , Ds          , Ds          , Ds          , Ds          
Ds          , Ds          , Rd^Vu       , Rd          , Ds          , Rd          , Uh          , Uh          , Uh          , Uu          , Uu          , Uu          , Uu          , Rd^Vu       , Uu          , Re          , Ds          , Ds          , Qxua        , Qxua        , Ds          , Ds          , Ds          , Ds          , Uu          , Qxua        , Qxua        , Qxua        , Qxua        , Uh          , Ds          , Ds          , Ds          , Ds          , Ds          , Ds          , Ds          , Ds          , Ds          , Qxua        , Ds          , Ds          , Ds          , Ds          , Ds          , Ds          
Ds          , Rd          , Rd          , Ds          , Ds          , Ds          , Re          , Uh          , Uh          , Uh          , 4 Kay       , Uu          , Uu          , Uu          , Uu          , Re          , Re          , Ds          , Ds          , Ds          , Ds          , Rd          , Uu          , Rb          , Uu          , Uu          , Qxua        , Qxua        , Qxua        , Qxua        , Qxua        , Ds          , Ds          , Uh          , Uh          , Ds          , Ds          , Ds          , Ds          , Ds          , Ds          , Ds          , Ds          , Ds          , Ds          , Ds          
Ds          , Ds          , Ds          , Ds          , Re          , Re          , Ds          , Re          , Uh          , Cay         , Cay         , Cay         , Cay         , Uu          , Uu          , Uu          , Re          , Ds          , Ds          , Ds          , Uu          , Uu          , Uu          , Rb          , Uu          , Uu          , Qxua        , Qxua        , Qxua        , Qxua        , Qxua        , Ds          , Ds          , Ds          , Ds          , Ds          , Ds          , Ds          , Uh          , Ds          , Ds          , Ds          , Ds          , Ds          , Ds          , Ds          
Ds          , Ds          , Ds          , Re          , Ds          , Ds          , Qxua        , Ds          , Ds          , Uh          , Re          , Qxua        , Qxua        , Cay         , Cay         , Uu          , Ds          , Ds          , Uh          , Uu          , Uu          , Uu^Vu       , Rb          , Rb          , Uu          , Qxua        , Qxua        , Qxua        , Qxua        , Qxua        , Qxua        , Qxua        , Qxua        , Ds          , Ds          , Ds          , Qxua        , Ds          , Ds          , Uh          , Uh          , Ds          , Ds          , Ds          , Ds          , Ds          
Ds          , Ds          , Ds          , Re          , Ds          , Qxua        , Qxua        , Qxua        , Ds          , Rd          , Ds          , Re          , Re          , Qxua        , Uu          , Uu          , Ds          , Ds          , Uh          , Uu          , Uu          , Rb          , Rb          , Uu          , Qxua        , Qxua        , Qxua        , Qxua        , Qxua        , Qxua        , Qxua        , Qxua        , Qxua        , Qxua        , Qxua        , Qxua        , Qxua        , Qxua        , Ds          , Uh          , Ds          , Ds          , Qxua        , Ds          , Ds          , Ds          
Ds          , Ds          , Rd          , Re          , Ds          , Qxua        , Qxua        , Qxua        , Rd          , Rd          , Re          , Ds          , Re          , Qxua        , Qxua        , Uu          , Uu          , Uh          , Uu          , Uu          , Re          , Rb          , Re          , Qxua        , Qxua        , Qxua        , Qxua        , Qxua        , Qxua        , Qxua        , Qxua        , Qxua        , Qxua        , Qxua        , Qxua        , Qxua        , Qxua        , Qxua        , Qxua        , Ds          , Ds          , Ds          , Qxua        , Qxua        , Ds          , Ds          
Qxua        , Rd          , Ds          , Re          , Ds          , Ds          , Rd          , Rd          , Ds          , Uh          , Re          , Re          , Re          , Qxua        , Qxua        , Uu          , Uu          , Uu          , Ds          , Ds          , Rd          , Ds          , Ds          , Re          , Re          , Qxua        , Qxua        , Qxua        , Qxua        , Qxua        , Re          , Uu          , Uu          , Qxua        , Qxua        , Qxua        , Qxua        , Qxua        , Qxua        , Qxua        , Qxua        , Qxua        , Qxua        , Qxua        , Qxua        , Ds          
Qxua        , Uu          , Ds          , Re          , Re          , Rd          , Ds          , Ds          , Ds          , Re          , Ds          , Re          , Rd          , Re          , Re          , Qxua        , Ds          , Ds          , Ds          , Ds          , Ds          , Ds          , Ds          , Ds          , Ds          , Re          , Re          , Qxua        , Re          , Re          , Ds          , Uh          , Re          , Uu          , Qxua        , Qxua        , Qxua        , Qxua        , Qxua        , Qxua        , Qxua        , Qxua        , Qxua        , Qxua        , Qxua        , Qxua        
Qxua        , Uu          , Rb          , Re          , Uh          , Ds          , Uh          , Uh          , Qxua        , Ds          , Ds          , Ds          , Ds          , Ds          , Ds          , Ds          , Ds          , Ds          , Rd          , Ds          , Ds          , Rd          , Rd          , Ds          , Ds          , Rd          , Rd          , Re          , Re          , Ds          , Ds          , Ds          , Ds          , Re          , Uu          , Qxua        , Qxua        , Qxua        , Qxua        , Qxua        , Qxua        , Qxua        , Qxua        , Qxua        , Qxua        , Qxua        
Qxua        , Uu          , Rb          , Uh          , Qxua        , Uh          , Qxua        , Qxua        , Qxua        , Qxua        , Re          , Ds          , Ds          , Rd          , Rd          , Ds          , Ds          , Ds          , Ds          , Rd          , Ds          , Ds          , Ds          , Rd          , Re          , Ds          , Rb          , Rd          , Ds          , Ds          , Qxua        , Qxua        , Ds          , Re          , Uu          , Qxua        , Qxua        , Qxua        , Qxua        , Qxua        , Qxua        , Qxua        , Qxua        , Qxua        , Qxua        , Qxua        
Qxua        , Uu          , Rb          , Ds          , Ds          , Qxua        , Qxua        , Qxua        , Qxua        , Qxua        , Re          , Re          , Re          , Ds          , Rd          , Rd^Vu       , Ds          , Ds          , Ds          , Ds          , Re          , Ds          , Ds          , Re          , Re          , Rb          , Rb          , Re          , Uh          , Ds          , Qxua        , Qxua        , Ds          , Re          , Uu          , Qxua        , Qxua        , Qxua        , Qxua        , Qxua        , Qxua        , Qxua        , Qxua        , Qxua        , Qxua        , Qxua        
Qxua        , Uu          , Rd          , Ds          , Ds          , Ds          , Qxua        , Qxua        , Qxua        , Qxua        , Re          , Re          , Ds          , Re          , Rd          , Rd          , Ds          , Ds          , Ds          , Qxua        , Qxua        , Re          , Re          , Re          , Rb          , Rb          , Qxua        , Rb          , Re          , Ds          , Ds          , Ds          , Uh          , Re          , Uu          , Qxua        , Qxua        , Qxua        , Qxua        , Qxua        , Qxua        , Qxua        , Qxua        , Qxua        , Qxua        , Qxua        
Qxua        , Uu          , Ds          , Rd          , Ds          , Ds          , Ds          , Ds          , Ds          , Rd          , Ds          , Ds          , Ds          , Ds          , Ds          , Ds          , Ds          , Ds          , Re          , Re          , Uh          , Re          , Rd          , Rd^Vu       , Rb          , Qxua        , Qxua        , Rb          , Rb          , Re          , Re          , Ds          , Re          , Uu          , Qxua        , Qxua        , Qxua        , Qxua        , Qxua        , Qxua        , Qxua        , Qxua        , Qxua        , Qxua        , Qxua        , Qxua        
Qxua        , Uu          , Re          , Rd          , Rd          , Ds          , Ds          , Ds          , Rd          , Rd          , Qxua        , Qxua        , Qxua        , Ds          , Qxua        , Ds          , Ds          , Re          , Rb          , Uh          , Ds          , Ds          , Ds          , Re          , Re          , Qxua        , Uu          , Uu          , Qxua        , Rb          , Rb          , Re          , Uu          , Qxua        , Qxua        , Qxua        , Qxua        , Qxua        , Qxua        , Qxua        , Qxua        , Qxua        , Qxua        , Qxua        , Qxua        , Qxua        
Qxua        , Uu          , Rb          , Re          , Ds          , Re          , Re          , Rd          , Ds          , Ds          , Qxua        , Qxua        , Qxua        , Qxua        , Qxua        , Ds          , Qxua        , Re          , Rb          , Ds          , Qxua        , Qxua        , Qxua        , Ds          , Re          , Qxua        , Uu          , Uu          , Uu          , Qxua        , Uu          , Rb          , Qxua        , Qxua        , Qxua        , Qxua        , Qxua        , Qxua        , Qxua        , Qxua        , Qxua        , Qxua        , Qxua        , Qxua        , Qxua        , Qxua        
Qxua        , Uu          , Rb          , Re          , Ds          , Ds          , Ds          , Rd          , Re          , Qxua        , Qxua        , Qxua        , Qxua        , Qxua        , Qxua        , Qxua        , Qxua        , Uu          , Rb          , Ds          , Ds          , Qxua        , Ds          , Ds          , Re          , Uu          , Qxua        , Qxua        , Qxua        , Uu          , Qxua        , Rb          , Qxua        , Qxua        , Qxua        , Qxua        , Qxua        , Qxua        , Qxua        , Qxua        , Qxua        , Qxua        , Qxua        , Qxua        , Qxua        , Qxua        
Qxua        , Uu          , Uu          , Re          , Re          , Ds          , Ds          , Ds          , Rd          , Re          , Re          , Qxua        , Re          , Qxua        , Qxua        , Qxua        , Qxua        , Uu          , Rb          , Re          , Uh          , Uh          , Re          , Re          , Uu          , Uu          , Qxua        , Qxua        , Qxua        , Qxua        , Qxua        , Rb          , Rb          , Qxua        , Uu          , Qxua        , Qxua        , Qxua        , Qxua        , Qxua        , Qxua        , Qxua        , Qxua        , Qxua        , Qxua        , Qxua        
Qxua        , Qxua        , Uu          , Rb          , Rb          , Re          , Re          , Rd          , Ds          , Ds          , Rd          , Re          , Re          , Qxua        , Qxua        , Qxua        , Qxua        , Qxua        , Qxua        , Rb          , Qxu         , Uu          , Qxu         , Rb          , Rb          , Uu          , Re          , Uh          , Re          , Qxua        , Re          , Uu          , Uh          , Rb          , Rb          , Uu          , Qxua        , Qxua        , Qxua        , Qxua        , Qxua        , Qxua        , Qxua        , Qxua        , Qxua        , Qxua        
Qxua        , Qxua        , Qxua        , Uu          , Uu          , Uu          , Qxua        , Re          , Re          , Ds          , Ds          , Rd          , Ds          , Re          , Re          , Qxua        , Qxua        , Qxua        , Qxua        , Rd          , Rb          , Qxu         , Rb          , Rb          , Uu          , Re          , Ds          , Re          , Ds          , Re          , Rd          , Uu          , Uu          , Uu          , Uu          , Rb          , Uu          , Qxua        , Qxua        , Qxua        , Qxua        , Qxua        , Qxua        , Qxua        , Qxua        , Qxua        
Qxua        , Qxua        , Qxua        , Qxua        , Qxua        , Qxua        , Qxua        , Rb          , Qxua        , Re          , Re          , Ds          , Ds          , Ds          , Re          , Qxua        , Re          , Qxua        , Qxua        , Rd          , Qxu         , Rb          , Qxua        , Qxua        , Qxua        , Re          , Rd          , Ds          , Ds          , Ds          , Rd          , Re          , Rb          , Qxua        , Qxua        , Rb          , Uu          , Qxua        , Qxua        , Qxua        , Qxua        , Qxua        , Qxua        , Qxua        , Qxua        , Qxua        
Qxua        , Qxua        , Qxua        , Qxua        , Qxua        , Qxua        , Qxua        , Qxua        , Qxua        , Qxua        , Qxua        , Re          , Re          , Ds          , Re          , Re          , Cay         , Cay         , Rd          , Rd          , Ds          , Uu          , Qxua        , Qxua        , Qxua        , Qxua        , Re          , Rd          , Re          , Re          , Rb          , Rb          , Qxua        , Qxua        , Qxua        , Rb          , Qxua        , Qxua        , Qxua        , Qxua        , Qxua        , Qxua        , Qxua        , Qxua        , Qxua        , Qxua        
Qxua        , Qxua        , Qxua        , Qxua        , Qxua        , Qxua        , Qxua        , Qxua        , Qxua        , Qxua        , Qxua        , Qxua        , Rb          , Re          , Qxua        , Qxua        , Cay         , 5 Kay       , Rd          , Ds          , Ds          , Qxua        , Qxua        , Qxua        , Qxua        , Qxua        , Qxua        , Qxua        , Rb          , Rb          , Qxua        , Qxua        , Qxua        , Qxua        , Qxua        , Rb          , Qxua        , Qxua        , Qxua        , Qxua        , Qxua        , Qxua        , Qxua        , Qxua        , Qxua        , Qxua        
Qxua        , Qxua        , Qxua        , Qxua        , Qxua        , Qxua        , Qxua        , Qxua        , Uu          , Qxua        , Uu          , Uu          , Rb          , Uu          , Qxua        , Qxua        , Qxua        , Cay         , Ds          , Ds          , Qxua        , Qxua        , Qxua        , Qxua        , Qxua        , Qxua        , Qxua        , Qxua        , Uu          , Uu          , Uu          , Qxua        , Qxua        , Qxua        , Uu          , Rb          , Uu          , Qxua        , Qxua        , Qxua        , Uu          , Re          , Re          , Qxua        , Qxua        , Qxua        
Qxua        , Qxua        , Qxua        , Qxua        , Uu          , Qxua        , Uu          , Uu          , Uu^Vu       , Uu          , Rb          , Rb          , Rd          , Uu          , Uu          , Qxua        , Rd          , Qxua        , Ds          , Ds          , Qxua        , Qxua        , Qxua        , Qxua        , Qxua        , Qxua        , Qxua        , Qxua        , Uu          , Uu          , Rb          , Uu          , Rb          , Uu          , Rb          , Rb          , Uu          , Qxua        , Uu          , Uu          , Re^Vct      , Ce          , Re          , Re          , Qxua        , Qxua        
Qxua        , Qxua        , Qxua        , Qxua        , Uu          , Uu          , Uu          , Uu          , Uu          , Uu          , Rb          , Rb          , Uu          , Rd          , Rd          , Rd          , Qxua        , Rd          , Rd          , Ds          , Qxua        , Qxua        , Re          , Qxua        , Qxua        , Qxua        , Qxua        , Qxua        , Rb          , Rb          , Uu          , Rb          , Qxua        , Rb          , Uu          , Rb          , Rb          , Rb          , Rb          , Ce          , Ce          , Ce          , Re^Vct      , Re          , Re          , Qxua        
Qxua        , Qxua        , Qxua        , Uu          , Uu          , Uu          , Rb          , Rb          , Rb          , Rb          , Qxua        , Uu          , Qxua        , Qxua        , Qxua        , Qxua        , Qxua        , Uu          , Rb          , Rd          , Rd          , Re          , Ds          , Re          , Re          , Qxua        , Rb          , Rb          , Uu          , Uu          , Qxua        , Qxua        , Qxua        , Qxua        , Qxua        , Rb          , Qxua        , Qxua        , Qxua        , Uu          , Ce          , 3 Ke        , Ce          , Re          , Re          , Gg          
Qxua        , Qxua        , Qxua        , Uu          , Uu          , Rb          , Uu          , Uu^Vu       , Re          , Re          , Re          , Qxua        , Qxua        , Qxua        , Qxua        , Qxua        , Qxua        , Qxua        , Qxua        , Rb          , Rd^Vu       , Ds          , Qxua        , Ds          , Rd          , Rb          , Uu          , Uu          , Uu          , Qxua        , Qxua        , Qxua        , Qxua        , Qxua        , Qxua        , Rb          , Uu          , Qxua        , Qxua        , Uu          , Uu          , Re^Vct      , Re          , Re          , Re          , Gg          
Qxua        , Qxua        , Qxua        , Uu          , Uu          , Uu          , Uu          , Re          , Ds          , Ds          , Re          , Qxua        , Qxua        , Qxua        , Qxua        , Qxua        , Qxua        , Qxua        , Qxua        , Qxua        , Qxua        , Ds          , Ds          , Ds          , Rd          , Rb          , Rb          , Rb          , Rb          , Qxua        , Qxua        , Qxua        , Qxua        , Qxua        , Qxua        , Rb          , Uu          , Uu          , Qxua        , Qxua        , Qxua        , Uu          , Re          , Re          , Re          , Gs^Fp       
Qxua        , Qxua        , Qxua        , Qxua        , Qxua        , Uu          , Uu          , Re          , Re          , Re          , Qxua        , Qxua        , Qxua        , Qxua        , Qxua        , Qxua        , Qxua        , Qxua        , Qxua        , Qxua        , Qxua        , Re          , Re          , Re          , Rb          , Rb          , Rb          , Qxua        , Qxua        , Rb          , Rb          , Qxua        , Qxua        , Qxua        , Uu          , Rb          , Ce          , Uu          , Qxua        , Qxua        , Qxua        , 2 Re        , Re          , Re          , Gg          , Gg          
Qxua        , Qxua        , Qxua        , Qxua        , Re          , Uu          , Uu          , Qxua        , Qxua        , Qxua        , Qxua        , Qxua        , Qxua        , Qxua        , Qxua        , Qxua        , Qxua        , Qxua        , Qxua        , Qxua        , Qxua        , Qxua        , Qxua        , Qxua        , Qxua        , Qxua        , Qxua        , Rb          , Rb          , Uu          , Qxua        , Rb          , Rb          , Uu          , Rb          , Rb          , Ce          , Uu          , Re          , Re          , Re          , Re          , Re          , Re          , Gg^Vh       , Gg          
Qxua        , Qxua        , Qxua        , Qxua        , Re          , Uu          , Uu          , Qxua        , Qxua        , Qxua        , Qxua        , Qxua        , Qxua        , Qxua        , Qxua        , Qxua        , Qxua        , Qxua        , Qxua        , Qxua        , Qxua        , Qxua        , Qxua        , Qxua        , Qxua        , Qxua        , Qxua        , Uu          , Uu          , Rb          , Rb          , Qxua        , Qxua        , Rb          , Qxu         , Uu          , Ce          , Re^Vct      , Re^Vct      , Re          , Qxua        , Re          , Re          , Gg          , Gs^Fp       , Gg          
Qxua        , Qxua        , Qxua        , Qxua        , Qxua        , Uu          , Qxua        , Qxua        , Qxua        , Qxua        , Qxua        , Qxua        , Qxua        , Qxua        , Qxua        , Qxua        , Qxua        , Qxua        , Qxua        , Qxua        , Qxua        , Qxua        , Qxua        , Qxua        , Qxua        , Qxua        , Qxua        , Qxua        , Qxua        , Qxua        , Re          , Re          , Re          , Re          , Re^Vct      , Ce          , 1 Ke        , Ce          , Ce          , Re          , Re          , Re          , Gg          , Gg          , Gg          , Gs^Fp       
Qxua        , Qxua        , Qxua        , Qxua        , Qxua        , Qxua        , Qxua        , Qxua        , Qxua        , Qxua        , Qxua        , Qxua        , Qxua        , Qxua        , Qxua        , Qxua        , Qxua        , Qxua        , Qxua        , Qxua        , Qxua        , Qxua        , Qxua        , Qxua        , Qxua        , Qxua        , Qxua        , Qxua        , Re          , Re          , Gg          , Gg          , Gs^Fp       , Gg          , Gg          , Gg          , Gg          , Gs^Fp       , Gg          , Gg          , Gg          , Gg          , Gg          , Gg          , Gs^Fp       , Gs^Fp       
