border_size=1
usage=map

Qxua        , Qxua        , Qxua        , Qxua        , Qxua        , Qxua        , Qxua        , Qxua        , Qxua        , Qxua        , Qxua        , Qxua        , Qxua        , Qxua        , Qxua        , Qxua        , Qxua        , Qxua        , Qxua        , Qxua        , Qxua        , Qxua        , Qxua        , Qxua        , Qxua        , Qxua        , Qxua        , Qxua        , Qxua        , Qxua        , Qxua        , Qxua        , Qxua        , Qxua        
Qxua        , Qxua        , Qxua        , Qxua        , Qxua        , Qxua        , Qxua        , Qxua        , Qxua        , Qxua        , Qxua        , Qxua        , Qxua        , Qxua        , Qxua        , Qxua        , Qxua        , Qxua        , Qxua        , Qxua        , Qxua        , Qxua        , Qxua        , Qxua        , Qxua        , Qxua        , Qxua        , Qxua        , Qxua        , Qxua        , Qxua        , Qxua        , Qxua        , Qxua        
Qxua        , Qxua        , Qxua        , Qxua        , Qxua        , Qxua        , Qxua        , Qxua        , Qxua        , Qxua        , Qxua        , Qxua        , Qxua        , Qxua        , Qxua        , Qxua        , Qxua        , Qxua        , Qxua        , Qxua        , Qxua        , Qxua        , Qxua        , Qxua        , Qxua        , Qxua        , Qxua        , Qxua        , Qxua        , Qxua        , Qxua        , Qxua        , Qxua        , Qxua        
Qxua        , Qxua        , Qxua        , Qxua        , Qxua        , Qxua        , Qxua        , Qxua        , Qxua        , Qxua        , Qxua        , Qxua        , Qxua        , Qxua        , Qxua        , Qxua        , Qxua        , Qxua        , Qxua        , Qxua        , Qxua        , Qxua        , Qxua        , Qxua        , Qxua        , Qxua        , Qxua        , Qxua        , Qxua        , Qxua        , Qxua        , Qxua        , Qxua        , Qxua        
Qxua        , Qxua        , Qxua        , Qxua        , Qxua        , Qxua        , Qxua        , Qxua        , Qxua        , Qxua        , Qxua        , Qxua        , Qxua        , Qxua        , Ds          , Qxua        , Ds          , Ds          , Ds          , Ds          , Ds          , Qxua        , Qxua        , Qxua        , Qxua        , Qxua        , Qxua        , Qxua        , Qxua        , Qxua        , Qxua        , Qxua        , Qxua        , Qxua        
Qxua        , Qxua        , Qxua        , Qxua        , Qxua        , Qxua        , Qxua        , Qxua        , Qxua        , Qxua        , Qxua        , Qxua        , Ds          , Ds          , Rd          , Ds          , Cay         , 4 Kay       , Cay         , Ds          , Ds          , Dd          , Dd          , Qxua        , Qxua        , Qxua        , Qxua        , Qxua        , Qxua        , Qxua        , Qxua        , Qxua        , Qxua        , Qxua        
Qxua        , Qxua        , Qxua        , Qxua        , Qxua        , Qxua        , Ds          , Dd          , Ds          , Qxua        , Qxua        , Ds          , Rd          , Rd          , Cay         , Cay         , Ds          , Cay         , Ds          , Cay         , Rd          , Dd          , Dd          , Qxua        , Dd          , Qxua        , Qxua        , Qxua        , Qxua        , Qxua        , Qxua        , Ds          , Ds          , Ds          
Qxua        , Qxua        , Qxua        , Qxua        , Qxua        , Qxua        , Ds          , Dd          , Rd^Vu       , Ds          , Ds          , Rd          , Ds          , Ds          , Qxua        , Ds          , Qxua        , Qxua        , Qxua        , Qxua        , Dd          , Rd          , Rd          , Ds          , Rd          , Ds          , Ds          , Qxua        , Qxua        , Qxua        , Qxua        , Qxua        , Ds          , Ds          
Qxua        , Qxua        , Qxua        , Qxua        , Qxua        , Qxua        , Ds          , Dd          , Rd          , Rd          , Rd          , Rd          , Ds          , Qxua        , Qxua        , Qxua        , Qxua        , Qxua        , Qxua        , Qxua        , Qxua        , Ds          , Ds          , Rd          , Ds          , Rd          , Rd          , Dd          , Dd          , Qxua        , Qxua        , Qxua        , Qxua        , Ds          
Qxua        , Qxua        , Qxua        , Qxua        , Qxua        , Qxua        , Qxua        , Ds          , Ds          , Ds          , Ds^Dr       , Rd          , Tphy^Dr     , Ds          , Qxua        , Qxua        , Qxua        , Qxua        , Qxua        , Qxua        , Qxua        , Qxua        , Qxua        , Dd          , Dd          , Ds^Vu       , Rd          , Ds^Dr       , Dd          , Dd          , Qxua        , Qxua        , Qxua        , Qxua        
Qxua        , Qxua        , Qxua        , Qxua        , Qxua        , Qxua        , Qxua        , Qxua        , Qxua        , Qxua        , Qxua        , Rd          , Rd          , Ds          , Qxua        , Qxua        , Qxua        , Qxua        , Qxua        , Qxua        , Qxua        , Qxua        , Qxua        , Qxua        , Qxua        , Ds          , Ds          , Rd          , Dd          , Qxua        , Qxua        , Qxua        , Qxua        , Qxua        
Ds          , Qxua        , Ds          , Ds          , Ds          , Qxua        , Qxua        , Qxua        , Qxua        , Qxua        , Qxua        , Rd          , Rd          , Ds          , Qxua        , Qxua        , Qxua        , Qxua        , Dd          , Dd          , Qxua        , Qxua        , Qxua        , Qxua        , Qxua        , Dd          , Dd          , Rd          , Dd          , Qxua        , Qxua        , Qxua        , Qxua        , Qxua        
Dd          , Ds          , Dd          , Dd          , Dd          , Ds          , Ds          , Qxua        , Qxua        , Qxua        , Qxua        , Ds          , Rd          , Ds          , Ds          , Qxua        , Qxua        , Qxua        , Qxua        , Ds          , Ds          , Qxua        , Qxua        , Qxua        , Qxua        , Dd          , Dd          , Rd          , Ds          , Qxua        , Qxua        , Ds          , Ds          , Qxua        
Dd          , Dd          , Ds          , Dd          , Ds          , Dd          , Qxua        , Qxua        , Dd          , Ds          , Ds          , Ds          , Rd          , Rd          , Rd          , Ds          , Ds          , Qxua        , Qxua        , Ds          , Ds          , Qxua        , Qxua        , Qxua        , Qxua        , Dd          , Dd          , Rd          , Ds          , Qxua        , Ds          , Ds          , Ds          , Ds          
Ds          , Ds          , Qxua        , Ds          , Qxua        , Qxua        , Dd          , Dd          , Hd          , Dd          , Rd          , Rd          , Dd          , Ds          , Ds          , Rd          , Dd          , Qxua        , Qxua        , Ds          , Ds          , Qxua        , Qxua        , Qxua        , Ds          , Ds          , Ds          , Rd          , Ds          , Qxua        , Qxua        , Ds          , Ds          , Ds          
Qxua        , Qxua        , Qxua        , Qxua        , Qxua        , Qxua        , Dd          , Hd          , Rd          , Rd          , Rd          , Rd          , Dd          , Qxua        , Ds          , Rd          , Dd          , Qxua        , Qxua        , Ds          , Qxua        , Qxua        , Qxua        , Ds          , Qxua        , Qxua        , Qxua        , Rd          , Rd          , Ds          , Qxua        , Qxua        , Qxua        , Qxua        
Qxua        , Qxua        , Qxua        , Qxua        , Ds          , Ds          , Rd          , Rd          , Dd          , Ds^Vu       , Dd          , Dd          , Qxua        , Qxua        , Ds          , Rd          , Ds          , Qxua        , Qxua        , Ds          , Qxua        , Qxua        , Qxua        , Ds          , Qxua        , Ds          , Dd          , Ds          , Rd          , Ds          , Qxua        , Qxua        , Qxua        , Qxua        
Qxua        , Qxua        , Qxua        , Qxua        , Dd          , Dd          , Rd          , Dd          , Hd          , Dd          , Dd          , Qxua        , Qxua        , Qxua        , Qxua        , Rd          , Rd          , Qxua        , Qxua        , Qxua        , Qxua        , Qxua        , Dd          , Ds          , Ds^Vu       , Qxua        , Dd          , Dd          , Ds^Dr       , Rd          , Dd          , Qxua        , Qxua        , Qxua        
Qxua        , Qxua        , Qxua        , Qxua        , Ds          , Dd          , Rd          , Dd          , Dd          , Dd          , Qxua        , Qxua        , Qxua        , Qxua        , Qxua        , Rd          , Rd          , Ds          , Qxua        , Dd          , Hd          , Hd          , Dd          , Dd          , Ds          , Dd          , Hd          , Hd          , Dd          , Dd          , Dd          , Qxua        , Qxua        , Qxua        
Qxua        , Qxua        , Qxua        , Qxua        , Ds          , Rd          , Rd          , Ds^Dr       , Dd          , Ds          , Ds          , Qxua        , Qxua        , Qxua        , Qxua        , Rd          , Rd          , Ds          , Ds          , Dd          , Qxua        , Qxua        , Qxua        , Ds          , Ds          , Dd          , Dd          , Dd          , Rd          , Rd          , Qxua        , Qxua        , Qxua        , Qxua        
Qxua        , Qxua        , Qxua        , Qxua        , Qxua        , Ds          , Dd          , Rd          , Rd          , Dd          , Dd          , Qxua        , Dd          , Ds          , Ds          , Rd          , Rd          , Ds          , Qxua        , Qxua        , Qxua        , Qxua        , Qxua        , Qxua        , Qxua        , Ds          , Qxua        , Ds          , Rd          , Dd          , Dd          , Qxua        , Qxua        , Qxua        
Qxua        , Qxua        , Qxua        , Qxua        , Qxua        , Qxua        , Qxua        , Ds          , Qxua        , Rd          , Rd          , Dd          , Hd          , Dd          , Rd          , Rd          , Ds          , Ds          , Qxua        , Qxua        , Ds          , Ds          , Qxua        , Qxua        , Qxua        , Qxua        , Qxua        , Qxua        , Rd          , Dd          , Ds          , Qxua        , Qxua        , Ds          
Ds          , Qxua        , Ds          , Qxua        , Qxua        , Qxua        , Qxua        , Qxua        , Ds          , Ds          , Ds          , Rd          , Rd          , Rd          , Dd          , Ds          , Qxua        , Qxua        , Qxua        , Qxua        , Qxua        , Ds          , Qxua        , Qxua        , Qxua        , Qxua        , Ds          , Ds          , Qxua        , Rd          , Dd          , Qxua        , Qxua        , Ds          
Dd          , Ds          , Ds          , Ds          , Qxua        , Qxua        , Ds          , Ds          , Rd          , Cay         , Rd          , Rd          , Ds          , Dd          , Qxua        , Qxua        , Qxua        , Qxua        , Qxua        , Qxua        , Qxua        , Qxua        , Dd          , Ds          , Ds          , Qxua        , Qxua        , Ds          , Ds          , Rd          , Dd          , Ds          , Qxua        , Qxua        
Dd          , Dd          , Ds          , Ds          , Qxua        , Qxua        , Ds          , Cay         , Cay         , 5 Kay       , Cay         , Cay         , Qxua        , Qxua        , Qxua        , Qxua        , Qxua        , Qxua        , Qxua        , Qxua        , Qxua        , Qxua        , Dd          , Ds          , Ds          , Qxua        , Qxua        , Qxua        , Ds          , Rd          , Ds          , Ds          , Qxua        , Qxua        
Dd          , Ds          , Qxua        , Qxua        , Qxua        , Qxua        , Qxua        , Ds          , Ds          , Rd          , Ds          , Qxua        , Ds          , Ds          , Ds          , Qxua        , Dd          , Dd          , Dd          , Qxua        , Dd          , Dd          , Rd          , Rd          , Ds          , Qxua        , Qxua        , Qxua        , Ds          , Rd          , Ds          , Qxua        , Qxua        , Qxua        
Ds          , Ds          , Qxua        , Qxua        , Qxua        , Qxua        , Dd          , Ds          , Rd          , Rd          , Rd          , Ds^Vu       , Rd          , Dd          , Dd          , Dd          , Hd          , Dd          , Ds          , Dd          , Rd          , Rd          , Rd          , Ds          , Ds          , Qxua        , Ds          , Ds          , Rd          , Rd          , Ds          , Qxua        , Qxua        , Qxua        
Qxua        , Qxua        , Qxua        , Qxua        , Qxua        , Ds          , Rd          , Rd          , Dd          , Ds          , Dd          , Rd          , Rd^Dr       , Rd          , Rd          , Dd          , Dd          , Dd          , Rd          , Rd          , Ds          , Ds          , Dd          , Rd          , Rd          , Ds          , Rd          , Rd          , Dd          , Ds^Vu       , Ds          , Qxua        , Qxua        , Qxua        
Qxua        , Qxua        , Qxua        , Qxua        , Dd          , Ds          , Rd          , Ds^Vu       , Dd          , Hd          , Hd          , Dd          , Ds          , Rd          , Rd          , Rd          , Rd          , Rd          , Ds          , Ds          , Ds          , Qxua        , Qxua        , Dd          , Dd          , Rd          , Rd          , Dd          , Dd          , Ds          , Qxua        , Qxua        , Qxua        , Qxua        
Qxua        , Qxua        , Qxua        , Qxua        , Ds          , Ds          , Ds          , Dd          , Qxua        , Dd          , Qxua        , Dd          , Dd          , Dd          , Dd          , Rd          , Rd          , Ds          , Qxua        , Ds          , Qxua        , Qxua        , Qxua        , Qxua        , Qxua        , Ds          , Rd          , Dd          , Dd          , Dd          , Qxua        , Qxua        , Qxua        , Qxua        
Qxua        , Qxua        , Qxua        , Qxua        , Qxua        , Ds          , Qxua        , Qxua        , Qxua        , Qxua        , Qxua        , Qxua        , Dd          , Hd          , Dd          , Rd          , Rd          , Ds          , Qxua        , Qxua        , Qxua        , Qxua        , Qxua        , Qxua        , Qxua        , Ds          , Rd          , Dd          , Dd          , Dd          , Qxua        , Qxua        , Qxua        , Ds          
Ds          , Qxua        , Qxua        , Qxua        , Qxua        , Qxua        , Qxua        , Qxua        , Ds          , Ds          , Dd          , Dd          , Dd          , Dd          , Ds          , Rd          , Rd          , Ds          , Ds          , Qxua        , Qxua        , Qxua        , Qxua        , Qxua        , Dd          , Ds          , Rd          , Dd          , Dd          , Dd          , Qxua        , Qxua        , Ds          , Ds          
Ds          , Ds          , Ds          , Qxua        , Qxua        , Qxua        , Qxua        , Qxua        , Qxua        , Dd          , Hd          , Hd          , Dd          , Qxua        , Qxua        , Ds          , Rd          , Ds          , Qxua        , Qxua        , Qxua        , Qxua        , Qxua        , Qxua        , Dd          , Dd          , Rd          , Ds          , Ds          , Ds          , Qxua        , Qxua        , Qxua        , Ds          
Ds          , Ds          , Qxua        , Qxua        , Qxua        , Qxua        , Qxua        , Qxua        , Ds          , Dd          , Dd          , Hd          , Dd          , Qxua        , Qxua        , Qxua        , Ds          , Rd          , Ds          , Qxua        , Qxua        , Qxua        , Qxua        , Qxua        , Ds          , Ds          , Rd          , Rd          , Ds          , Qxua        , Ds          , Qxua        , Ds          , Qxua        
Qxua        , Qxua        , Qxua        , Qxua        , Qxua        , Qxua        , Ds          , Ds          , Ds          , Ds          , Gd          , Dd          , Ds          , Ds          , Ds          , Ds          , Rd          , Rd          , Ds          , Ds          , Dd          , Dd          , Dd          , Ds          , Ds          , Rd          , Ds          , Ds          , Dd          , Dd          , Dd          , Ds          , Ds          , Ds          
Qxua        , Qxua        , Ds          , Qxua        , Ds          , Ds          , Gd          , Ds          , Ds          , Gd          , Ds          , Ds          , Chr         , Ds          , Ds          , Rd          , Ds          , Ds          , Ds          , Ds          , Dd          , Dd          , Ds          , Ds          , Ds          , Rd          , Ds          , Dd          , Ds          , Dd          , Ds          , Ds          , Ds          , Ds          
Qxua        , Ds          , Ds          , Ds          , Ds          , Ds          , Gd          , Ds          , Gd          , Gd          , Gd          , Gd          , Ds          , Ds          , Dd          , Rd          , Dd          , Ds          , Gd          , Ds          , Ds          , Ds          , Ds          , Ds          , Gd          , Gd          , Ds          , Ds          , Ds          , Gd          , Gd          , Ds          , Ds          , Gd          
Ds          , Ds          , Gd          , Ds          , Gd          , Gd          , Ds          , Ds          , Gd          , Gs          , Gs          , Gd          , Ds          , Dd          , Dd          , Rd          , Rd          , Ds          , Ds          , Gd^Vhr      , Ds          , Ds          , Gd          , Gd          , Gd          , Ds          , Ds          , Ds          , Ds          , Ds          , Gd          , Ds          , Ds          , Gd          
Ds          , Ds          , Gd          , Ds          , Gd          , Gd          , Gd          , Gd          , Gs          , Gs          , Gs          , Gd          , Ds          , Ds          , Re          , Re          , Chr         , Ds          , Ds          , Gd          , Gd          , Gd          , Gs          , Gd          , Ds          , Ds          , Ds          , Gd          , Ds          , Ds          , Gd          , Gd          , Gd          , Gd          
Gd          , Gd          , Gs          , Gd          , Gs^Vct      , Gs          , Ce          , Gs          , Ce          , Gs^Vct      , Gs          , Gd          , Rr          , Rd          , Ds          , Dd          , Ds          , Ds          , Gd          , Gd          , Gs          , Gs          , Gs          , Gd          , Gd          , Ds          , Ds          , Gd          , Ds          , Ds          , Gd          , Gd          , Gs          , Gd          
Gs          , Gs          , Gg          , Gg          , Gg          , Gg          , Gs^Fds      , Ce          , 3 Ke        , Ce          , Ce          , Gd          , Rp^Vhcr     , Gd          , Gd          , Ds          , Gd          , Gd          , Ce          , Gs          , Gg          , Gs          , Ds          , Ds          , Gd          , Ds          , Ds          , Gd          , Gd          , Ds          , Gd          , Gs          , Gg          , Gs          
Gg          , Gg          , Gg          , Gg          , Gs^Fds      , Gs^Fds      , Gs^Fds      , Gs^Fds      , Gs^Fds      , Gs^Fds      , Ce          , Rp          , Rp          , Rp          , Rp          , Gd          , Gs          , Ce          , 1 Ke        , Ce          , Gg          , Gg          , Gs          , Ds          , Gs          , Gd          , Gd          , Ds          , Gd          , Gd          , Gg          , Gg          , Gg          , Gg          
Gg          , Gg          , Gll^Fp      , Gs^Fms      , Gll         , Gll         , Gs^Fds      , Gs^Fds      , Gs^Fds      , Gs^Fds      , Gs^Fds      , Rp          , Rr          , Rr          , Rp          , Gs          , Gg          , Ce          , Ce          , Ce          , Gg          , Gg^Vct      , Gg          , Gs          , Gg          , Gs          , Gs          , Gs          , Gg          , Gg          , Gll^Fp      , Gll^Fp      , Gll^Fp      , Gg          
Gg          , Gg          , Gll         , Gll         , Gs^Fms      , Gs^Fms      , Gs^Fms      , Gs^Fms      , Gs^Fds      , Gs^Fds      , Gg          , Gg          , Gg          , Rr          , Rr          , Gg^Vct      , Gg          , Gg          , Gg          , Gg          , Gg          , Gg          , Gg          , Gg          , Gg          , Gg          , 2 Gg        , Gg          , Gll         , Gll         , Gs^Fms      , Gll^Fp      , Gll^Fp      , Gs^Fms      
Gg          , Gg          , Gll         , Gll         , Gll^Fp      , Gs^Fms      , Gs^Fms      , Gs^Fms      , Gs^Fms      , Gll         , Gg          , Gg          , Gg          , Rr          , Rr          , Gg          , Gg          , Gg^Vct      , Gg          , Gg          , Gg          , Gg          , Gg          , Gg          , Ss          , Gg          , Gg          , Gg          , Gs^Fms      , Gs^Fms      , Gs^Fms      , Gs^Fms      , Gs^Fms      , Gs^Fms      
Gg          , Gll^Fp      , Gll^Fp      , Gll^Fp      , Gll^Fp      , Gll^Fp      , Gll^Fp      , Gs^Fms      , Gs^Fms      , Gs^Fms      , Gg          , Gg          , Rr          , Rr          , Rr          , Gg          , Gg          , Gg          , Gg          , Gg          , Gg          , Gg          , Gg          , Gll^Fp      , Ss          , Ss          , Gs^Fms      , Gs^Fms      , Gs^Fms      , Gs^Fms      , Gs^Fms      , Gs^Fms      , Gs^Fms      , Gs^Fms      
