border_size=1
usage=map

Md^Xm       , Md^Xm       , Md^Xm       , Md^Xm       , Md^Xm       , Md^Xm       , Md^Xm       , Md^Xm       , Md^Xm       , Mm          , Md^Xm       , Md^Xm       , Md^Xm       , Md^Xm       , Md          , Md          , Md          , Md          , Md          , Md          , Md          , Md          , Md          , Md          , Md          , Md          , Md          , Md          , Md          , Md          , Md          , Md          , Md          , Md          , Md          , Md          , Md          , Md          , Md          , Md          , Md          , Md          , Md          , Md          , Md          , Md          , Md          , Md          , Hhd         , Gd          , Gd          , Gd          
Md^Xm       , Md^Xm       , Md^Xm       , Md^Xm       , Md^Xm       , Md^Xm       , Md^Xm       , Md^Xm       , Md^Xm       , Md^Xm       , Md^Xm       , Md^Xm       , Md^Xm       , Md^Xm       , Md          , Md          , Md          , Md          , Md          , Md          , Md          , Md          , Md          , Md          , Md          , Md          , Md          , Md          , Md          , Cud         , 2 Kud       , Cud         , Md          , Md          , Md          , Md          , Md          , Md          , Md          , Md          , Md          , Md          , Md          , Md          , Md          , Md          , Md          , Md          , Hhd         , Gd          , Gd          , Gd          
Md^Xm       , Md^Xm       , Md^Xm       , Md^Xm       , Md^Xm       , Md^Xm       , Md^Xm       , Md^Xm       , Md^Xm       , Md^Xm       , Md^Xm       , Md^Xm       , Md          , Md          , Md          , Md          , Md          , Md          , Md          , Md          , Md          , Md          , Md          , Md          , Md          , Md          , Md          , Hh^Vhh      , Md          , Ce          , Ce          , Ce          , Md          , Mm^Vhh      , Md          , Md          , Md          , Md          , Md          , Md          , Md          , Md          , Md          , Md          , Md          , Md          , Hhd         , Hhd         , Hhd         , Gd          , Gd          , Gd          
Md^Xm       , Md^Xm       , Md^Xm       , Md^Xm       , Md^Xm       , Md^Xm       , Md^Xm       , Md^Xm       , Md^Xm       , Md^Xm       , Md          , Md          , Md          , Md          , Md          , Md          , Md          , Md          , Md          , Md          , Md          , Mm^Vhh      , Md          , Md          , Md          , Md          , Hhd         , Md          , Hhd         , Md          , Hhd         , Md          , Hhd         , Hhd         , Hhd         , Md          , Md          , Md          , Hhd         , Md          , Hhd         , Md          , Hhd         , Hhd         , Hhd         , Hhd         , Gd          , Gd          , Gd          , Gd          , Gd          , Gd          
Md^Xm       , Md^Xm       , Md^Xm       , Md^Xm       , Md^Xm       , Md^Xm       , Md^Xm       , Md^Xm       , Md          , Md          , Md          , Md          , Md          , Md          , Md          , Md          , Md          , Md          , Md          , Md          , Md          , Md          , Hhd         , Hhd         , Hhd         , Hhd         , Gd          , Hhd         , Gd          , Hhd         , Hhd         , Hhd         , Hhd         , Hhd         , Gd          , Hhd         , Hhd         , Hhd         , Gd          , Hhd         , Gs          , Hhd         , Gd          , Hhd         , Gd          , Gd          , Gd          , Gd          , Gd          , Gd          , Rd          , Rd          
Md^Xm       , Md^Xm       , Md^Xm       , Md^Xm       , Md          , Md^Xm       , Md          , Md          , Md          , Md          , Md          , Md          , Md          , Md          , Md          , Md          , Md          , Mm^Vhh      , Md          , Md          , Hhd         , Hhd         , Hhd         , Hhd         , Hhd         , Hhd         , Md          , Gd          , Gd          , Gd          , Gll^Fp      , Hh^Fp       , Gd          , Gd          , Gd          , Gd          , Ds          , Gd          , Ds          , Ds          , Ds          , Ds          , Ds          , Gd          , Gd          , Gd          , Gd          , Gd          , Gd          , Rd          , Ds          , Ds          
Md^Xm       , Md^Xm       , Md          , Md          , Md          , Md          , Md          , Md          , Md          , Md          , Md          , Md          , Md          , Md          , Hhd         , Md          , Md          , Md          , Hhd         , Hhd         , Hhd         , Hhd         , Gd          , Gd          , Gd          , Md          , Md          , Md          , Gd          , Gd          , Gll^Fp      , Gll^Fp      , Ds^Fp       , Ds          , Ds          , Ds          , Ds          , Ds          , Dd          , Ds          , Ds          , Gs          , Ds          , Gd          , Gs^Vc       , Gd          , Gd          , Gd          , Rd          , Gd          , Rd          , Ds          
Md          , Md          , Md          , Md          , Md          , Md          , Md          , Md          , Md          , Md          , Md          , Md          , Md          , Hhd         , Gs          , Hhd         , Hhd         , Hhd         , Gs          , Hhd         , Gd          , Gd          , Hhd         , Hhd         , Gd          , Hh          , Hh          , Hh          , Ds          , Gd          , Ds          , Gll^Fp      , Dd          , Dd          , Ds          , Ds          , Ds          , Ds          , Ds          , Ds          , Ds          , Ds          , Gd          , Gd          , Gd          , Gd          , Gd          , Rd          , Rd          , Rd          , Rd          , Rd          
Md          , Md          , Md          , Md          , Md          , Md          , Md          , Md          , Md          , Md          , Md          , Md          , Md          , Hhd         , Gs          , Gd          , Ww          , Gs          , Hhd         , Hhd         , Hhd         , Hhd         , Md          , Hhd         , Hhd         , Ds          , Ds          , Ds          , Ds          , Ds          , Ds          , Ds^Fp       , Ds          , Ds          , Ds          , Ds          , Ds^Es       , Gd          , Gd          , Gd          , Gd          , Gd          , Gd          , Gd          , Gd          , Gd          , Rd          , Rd          , Gd          , Gd          , Ds          , Ds          
Md          , Md          , Md          , Md          , Md          , Md          , Md          , Md          , Md          , Md          , Md          , Md          , Md          , Hhd         , Gs          , Gd          , Gd          , Gd          , Hhd         , Hhd         , Md          , Md          , Md          , Hhd         , Hhd         , Gd          , Gd          , Ds          , Ds          , Gd          , Gll^Fp      , Ds          , Ds          , Ds          , Ds          , Gd          , Gd          , Gd          , Gd          , Gd          , Gd          , Gd          , Qxe         , Gd          , Gd          , Rd^Es       , Gd          , Gd          , Gd          , Ds          , Rd          , Ds          
Md          , Md          , Md          , Md          , Md          , Md          , Md          , Md          , Hhd         , Md          , Md          , Md          , Md          , Hhd         , Hhd         , Gs          , Hhd         , Hhd         , Md          , Md          , Md          , Md          , Md          , Hhd         , Hh^Fp       , Gll^Fp      , Gll^Fp      , Gd          , Gd          , Gd          , Gd          , Gd          , Gd          , Gd          , Gd          , Gd          , Gd          , Gd          , Gd          , Gd          , Qxe         , Qxe         , Gd          , Gd          , Gd          , Rd          , Rd          , Gd          , Rd          , Ds          , Ds          , Ds          
Md          , Md          , Md          , Md          , Md          , Md          , Md          , Hhd         , Md          , Hhd         , Hhd         , Md          , Md          , Md          , Hhd         , Hhd         , Md          , Md          , Md          , Md          , Md          , Md          , Hhd         , Hhd         , Hh^Fp       , Gll^Fp      , Ds^Fp       , Gll^Fp      , Ds          , Gd          , Gd          , Gd          , Gd          , Gd          , Qxe         , Gd          , Qxe         , Qxe         , Qxe         , Qxe         , Gd          , Gd          , Ds          , Ds          , Ds          , Ds          , Rd          , Gd          , Gd          , Gd          , Gd          , Ds          
Md          , Md          , Md          , Md          , Md          , Md          , Hhd         , Md          , Md          , Md          , Hhd         , Md          , Md          , Md          , Hhd         , Hhd         , Hhd         , Md          , Md          , Md          , Md          , Md          , Hhd         , Hhd         , Gll^Fp      , Gll^Fp      , Ds^Fp       , Ds^Fp       , Ds          , Gd          , Gd          , Gd          , Qxe         , Qxe         , Qxe         , Qxe         , Qxe         , Qxe         , Gd          , Gd          , Rd          , Ds          , Ds          , Ds          , Rd^Es       , Rd          , Gd          , Gd          , Gd          , Gs^Vc       , Gd          , Gd          
Md          , Md          , Md          , Md          , Hhd         , Hhd         , Hhd         , Hhd         , Hhd         , Hhd         , Hhd         , Hhd         , Hhd         , Hhd         , Gd          , Gd          , Gd          , Hhd         , Hhd         , Hhd         , Hhd         , Hhd         , Gd          , Gd          , Gd          , Gd          , Ds          , Dd          , Rd          , Gd          , Qxe         , Qxe         , Qxe         , Qxe         , Qxe         , Qxe         , Gd          , Gd          , Gd          , Gd          , Rd          , Gd          , Rp          , Rd          , Rd          , Rd          , Gd          , Gd          , Hh          , Gd          , Gd          , Gd          
Md          , Md          , Md          , Hhd         , Hhd         , Hhd         , Hh^Fp       , Hh^Fp       , Gll^Fp      , Ds          , Ds          , Hhd         , Hh^Fp       , Hhd         , Gd          , Ds          , Ds^Es       , Gd          , Hhd         , Hhd         , Hhd         , Gd          , Gd          , Gd          , Gd          , Gd          , Rd^Es       , Rd          , Ds          , Gd          , Qxe         , Qxe         , Qxe         , Qxe         , Gd          , Gd          , Gd          , Gd          , Gd          , Rd          , Rp          , Rd          , Rd          , Rd          , Gd          , Gd          , Ds          , Hh          , Ds          , Ds          , Ds          , Gd          
Md          , Md          , Md          , Hhd         , Md          , Hhd         , Hhd         , Hh^Fp       , Gd^Fp       , Gd^Fp       , Ds          , Ds          , Ds^Fp       , Gd^Fp       , Gd          , Ds          , Ds          , Ds          , Hhd         , Hhd         , Gd          , Gd          , Gd          , Gd          , Ds          , Gs          , Ds          , Ds          , Qxe         , Qxe         , Qxe         , Qxe         , Qxe         , Gd          , Ds          , Ds          , Gd          , Gd          , Gd          , Rd          , Rd          , Rd          , Gd          , Gd          , Gd          , Gd          , Ds          , Ds          , Ds          , Ds          , Gd          , Gd          
Md          , Md          , Hhd         , Hhd         , Md          , Md          , Hhd         , Hhd         , Gd          , Gd^Fp       , Ds          , Ds          , Ds          , Gd^Fp       , Gd          , Ds          , Ds          , Ds          , Gd          , Hhd         , Gd          , Gd          , Hhd         , Ds          , Ds          , Rd          , Ds          , Qxe         , Qxe         , Qxe         , Md          , Hhd         , Chr         , Khr         , Chr         , Ds          , Ds          , Gd          , Rd          , Rd          , Gd          , Gd          , Gd          , Gd          , Gd          , Gd^Es       , Gd          , Ds          , Ds          , Gd          , Gd          , Hhd         
Hhd         , Hhd         , Hhd         , Hhd         , Hhd         , Hhd         , Hhd         , Gd          , Ds          , Ds          , Ds          , Ds          , Hhd         , Ds          , Hhd         , Gd          , Ds          , Ds          , Gd          , Gd          , Ds          , Gd          , Hhd         , Hhd         , Hhd         , Ds          , Ds          , Qxe         , Md          , Md          , Md          , Md          , Hhd         , Chr         , Gd          , Ds          , Gd          , Gd          , Rd^Es       , Gd          , Ds          , Gd          , Hhd         , Hhd         , Hhd         , Hhd         , Hhd         , Hhd         , Ds          , Gd          , Gd          , Hhd         
Hhd         , Hhd         , Hhd         , Hhd         , Hhd         , Hhd         , Gd          , Ds          , Gd          , Gd          , Hhd         , Hhd         , Md          , Hhd         , Gd          , Gd          , Gd          , Ds          , Gd          , Gd          , Ds          , Ds          , Ds          , Hhd         , Hhd         , Rd          , Ds          , Qxe         , Hhd         , Md          , Md          , Md          , Rd          , Gd          , Rp          , Gd          , Rd          , Rd          , Rd          , Ds          , Ds          , Hhd         , Md          , Md          , Md          , Hhd         , Ds          , Dd          , Ds          , Gd          , Hhd         , Hhd         
Gd          , Hhd         , Gd          , Hhd         , Hh^Vc       , Hhd         , Md          , Gd          , Md          , Hhd         , Hhd         , Md          , Md          , Md          , Hhd         , Gd          , Gd          , Gd          , Qxe         , Qxe         , Qxe         , Ds          , Ds          , Ds          , Gs^Vc       , Rd          , Gd          , Gd          , Gd          , Hhd         , Rd          , Rd          , Gd          , Rd          , Gd          , Rd          , Gd          , Gd          , Ds          , Ds          , Hhd         , Hhd         , Md          , Md          , Md          , Hhd         , Gd          , Ds          , Gd          , Gd          , Hhd         , Md          
Gd          , Gd          , Gd          , Gd          , Hhd         , Hhd         , Md          , Md          , Md          , Hhd         , Hhd         , Hhd         , Hhd         , Hhd         , Ds          , Ds          , Gd          , Qxe         , Qxe         , Qxe         , Qxe         , Qxe         , Gd          , Gd          , Gd          , Rd          , Gd          , Gd          , Rp          , Rd          , Gd          , Gd          , Gd          , Gd          , Gd          , Gd          , Hhd         , Ds          , Ds          , Ds          , Hhd         , Hhd         , Hhd         , Md          , Hhd         , Hhd         , Gd          , Gd          , Hhd         , Hhd         , Md          , Md          
Gd          , Gd          , Hhd         , Hhd         , Md          , Md          , Hhd         , Hhd         , Ds          , Ds          , Ds          , Hh^Fp       , Gll^Fp      , Gd          , Gd          , Gd          , Qxe         , Qxe         , Qxe         , Qxe         , Qxe         , Qxe         , Gd          , Gd^Es       , Gd          , Gd          , Gd          , Rd          , Rd          , Rd          , Ds          , Gd          , Gd^Es       , Gd          , Hhd         , Hhd         , Hhd         , Hhd         , Ds          , Ds          , Dd          , Hhd         , Ds          , Ds          , Hhd         , Hhd         , Gd          , Gd          , Hhd         , Hhd         , Md          , Md          
Gd          , Gd          , Gd          , Hhd         , Hhd         , Hhd         , Gg          , Gs          , Gs^Es       , Ds          , Gd          , Gll^Fp      , Gd          , Gd          , Qxe         , Qxe         , Qxe         , Qxe         , Qxe         , Qxe         , Qxe         , Gd          , Ds          , Ds          , Rd          , Rd          , Gd          , Gd          , Gd          , Ds          , Ds          , Gd          , Gd          , Gd          , Hhd         , Hhd         , Md          , Hhd         , Hhd         , Ds          , Dd          , Dd          , Dd          , Ds          , Gd          , Gd^Vo       , Gd          , Gd          , Hhd         , Hhd         , Md          , Md          
Gd          , Ce          , Ce          , Gd          , Gd          , Hhd         , Ds          , Gs          , Ds          , Gd          , Gd          , Gd          , Gd          , Qxe         , Qxe         , Qxe         , Qxe         , Qxe         , Gd          , Qxe         , Gd          , Qxe         , Ds          , Ds          , Rd          , Gd          , Gd          , Hhd         , Gd          , Gd          , Gd          , Gd          , Md          , Md          , Md          , Hhd         , Md          , Md          , Md          , Ds          , Ds          , Dd          , Dd          , Ds          , Gd          , Gd          , Gd          , Hhd         , Md          , Md          , Md          , Md          
Gd          , Gd          , 1 Ke        , Ce          , Gd          , Gd^Es       , Ds          , Ds          , Ds          , Gd          , Hhd         , Gd          , Ds          , Gd          , Gg          , Gd          , Gd          , Gd          , Gd          , Gd          , Qxe         , Qxe         , Ds          , Ds          , Rd          , Gd          , Ds          , Gd          , Hhd         , Hhd         , Hhd         , Hhd         , Md          , Md          , Md          , Md          , Md          , Md          , Md          , Hhd         , Hhd         , Ds          , Ds          , Ds          , Ds          , Gd          , Hhd         , Hhd         , Md          , Md          , Md          , Md          
Gd          , Gd          , Ce          , Ce          , Ds          , Ds          , Ds          , Ds          , Hhd         , Hhd         , Hhd         , Hhd         , Hhd         , Gd          , Gd          , Gd          , Rd          , Rd          , Ds          , Gd          , Gd          , Gd          , Gd          , Ds          , Rd          , Ds          , Ds          , Gll^Fp      , Hh^Fp       , Hhd         , Hhd         , Hhd         , Hhd         , Hhd         , Hhd         , Hhd         , Hhd         , Hh^Vo       , Hhd         , Md          , Md          , Hhd         , Hhd         , Ds          , Ds          , Hhd         , Md          , Md          , Md          , Md          , Md          , Md          
Gd          , Ce          , Ds          , Ds          , Dd          , Ds          , Gd          , Gd          , Rd          , Hhd         , Rd          , Hhd         , Rd          , Gd          , Rd          , Rd^Es       , Rd          , Ds          , Rd          , Gd          , Rd          , Gd          , Rd          , Rd          , Rd          , Ds          , Ds          , Gll^Fp      , Gll^Fp      , Hh^Fp       , Gll^Fp      , Ds          , Ds          , Ds          , Ds          , Ds          , Co          , Gs          , Hhd         , Md          , Md          , Md          , Md          , Hhd         , Md          , Md          , Md          , Md          , Md          , Md          , Md          , Md          
Gd          , Ce          , Gg          , Ds          , Rd          , Rd          , Rd          , Rd          , Rd          , Rd          , Ds          , Rd          , Gd          , Rd          , Gd          , Rd          , Ds^Es       , Rd          , Ds          , Rd          , Ds          , Rd^Es       , Dd          , Ds          , Rd          , Rd          , Rd          , Gd          , Gd          , Gll^Fp      , Ds          , Ds          , Ds          , Gd^Vo       , Ds          , Co          , 5 Ko        , Co          , Hhd         , Hhd         , Md          , Md          , Md          , Md          , Md          , Md          , Md          , Md          , Md          , Md          , Md          , Md          
Gd          , Ce          , Ce          , Rd          , Rd          , Rd^Es       , Rd          , Ds          , Ds          , Ds          , Ds          , Ds          , Ds          , Gd          , Ds          , Gd          , Ds          , Ds          , Ds          , Ds          , Ds          , Dd          , Dd          , Ds          , Ds          , Ds          , Gd^Es       , Rd          , Rd          , Rd          , Rd          , Rd          , Rd          , Ds          , Rd          , Co          , Co          , Co          , Hhd         , Hhd         , Md          , Md          , Md          , Md          , Md          , Md          , Md          , Md          , Md          , Md          , Md          , Md          
Rd          , Rd          , Rd          , 3 Ke        , Rd          , Rd          , Gd          , Ds          , Ds          , Ds^Vc       , Ds          , Ds^Dr       , Ds          , Rd          , Gd          , Gd          , Gd          , Ds          , Hhd         , Hhd         , Ds          , Ds          , Ds          , Dd          , Ds          , Gd          , Ds          , Ds          , Ds          , Ds          , Ds^Vo       , Ds          , Co          , Rd          , Gs          , Gs          , Gs          , Gs          , Hhd         , Hhd         , Md          , Md          , Md          , Md          , Md          , Md          , Md          , Md          , Md          , Md          , Md          , Md          
Gd          , Rd          , Gd          , Ce          , Gd          , Gd          , Ds          , Ds          , Gd^Es       , Ds          , Ds          , Ds          , Ds          , Ds          , Ds          , Hh          , Ds          , Ds          , Hhd         , Hhd         , Ds          , Gd          , Gd          , Gd^Es       , Gd          , Ds          , Ds          , Ds          , Ds          , Ds          , Ds          , Ds          , Hhd         , Hhd         , Hhd         , Hhd         , Hhd         , Hhd         , Hhd         , Hhd         , Md          , Md          , Md          , Md          , Md          , Md          , Md          , Md          , Md          , Md          , Md^Xm       , Md^Xm       
Gd          , 4 Gd        , Gd^Fp       , Gd          , Gd^Fp       , Ds          , Gd^Fp       , Gd          , Gd          , Ds          , Hhd         , Ds          , Hhd         , Hhd         , Hhd         , Ds          , Hhd         , Ds          , Hhd         , Hhd         , Hhd         , Ds          , Gd          , Gd          , Hhd         , Ds          , Hhd         , Ds          , Hhd         , Ds          , Hhd         , Hhd         , Hhd         , Hhd         , Hhd         , Hhd         , Hhd         , Hh^Vo       , Hhd         , Hhd         , Md          , Md          , Md          , Md          , Md          , Md          , Md          , Md          , Md^Xm       , Md^Xm       , Md^Xm       , Md^Xm       
Gd          , Gd          , Gd          , Gd          , Gd^Fp       , Gd^Fp       , Gd^Fp       , Gd          , Hhd         , Hhd         , Hhd         , Hhd         , Md          , Md          , Md          , Hhd         , Hhd         , Hhd         , Hhd         , Hhd         , Hhd         , Hhd         , Hhd         , Hhd         , Hhd         , Hhd         , Hhd         , Hhd         , Hhd         , Hhd         , Hhd         , Hhd         , Md          , Hhd         , Md          , Hhd         , Md          , Hhd         , Md          , Md          , Md          , Md          , Md          , Md          , Md          , Md          , Md^Xm       , Md^Xm       , Md^Xm       , Md^Xm       , Md^Xm       , Md^Xm       
Gg          , Gd          , Gd          , Gd          , Hhd         , Hh^Fp       , Hhd         , Hhd         , Md          , Md          , Md          , Md          , Md          , Md          , Md          , Md          , Md          , Md          , Md          , Hhd         , Md          , Md          , Md          , Md          , Md          , Md          , Md          , Md          , Md          , Md          , Md          , Md          , Md          , Md          , Md          , Md          , Md          , Md          , Md          , Md          , Md          , Md          , Md          , Md          , Md^Xm       , Md^Xm       , Md^Xm       , 6 Md^Xm     , Md^Xm       , Md^Xm       , Md^Xm       , Md^Xm       
Hhd         , Hhd         , Hhd         , Hhd         , Md          , Hhd         , Md          , Md          , Md          , Md          , Md^Xm       , Md          , Md^Xm       , Md          , Md^Xm       , Md          , Md          , Md          , Md          , Md          , Md          , Md          , Md          , Md          , Md          , Md          , Md          , Md          , Md          , Md          , Md          , Md          , Md          , Md          , Md          , Md          , Md          , Md          , Md          , Md          , Md          , Md          , Md          , Md^Xm       , Md^Xm       , Md^Xm       , Md^Xm       , Md^Xm       , Md^Xm       , Md^Xm       , Md^Xm       , Md^Xm       
Hhd         , Hhd         , Hhd         , Hhd         , Hhd         , Hhd         , Md          , Md          , Md          , Md          , Md          , Md^Xm       , Md^Xm       , Md^Xm       , Md^Xm       , Md^Xm       , Md^Xm       , Md          , Md          , Md          , Md          , Md          , Md          , Md          , Md          , Md          , Md          , Md          , Md          , Md          , Md          , Md          , Md          , Md          , Md          , Md          , Md          , Md          , Md          , Md          , Md          , Md          , Md          , Md^Xm       , Md^Xm       , Md^Xm       , Md^Xm       , Md^Xm       , Md^Xm       , Md^Xm       , Md^Xm       , Md^Xm       
