border_size=1
usage=map

Ms          , Ms          , Ms          , Ms          , Ms          , Aa          , Ms          , Ms          , Ms          , Ms          , Ms          , Ms          , Ms          , Ms          , Ms          , Ha          , Ha          , Ha          , Ha          , Ha          , Ha          , Ha          , Aa          , Aa          , Aa          , Aa          , Ha          , Ha          , Ha          , Aa          , Aa          , Ms          , Ms          , Ms          , Ms          , Ms          , Ms          , Aa          , Aa          , Aa          , Aa          , Aa          
Ms          , Ms          , Aa          , Aa          , Aa          , Ms          , Ms          , Ms          , Ms          , Ms          , Ms          , Ms          , Ms          , Ms          , Ms          , Aa          , Aa          , Ha          , Ha          , Ha          , Ha          , Aa          , Aa          , Aa          , Ms          , Aa          , Aa          , Ha          , Aa          , Ha          , Aa          , Aa          , Aa          , Ms          , Ms          , Ms          , Ms          , Ms          , Ms          , Aa          , Aa          , Aa          
Aa          , Ms          , Aa          , Aa          , Ms          , Aa          , Ms          , Ms          , Ms          , Ms          , Ms          , Ms          , Ms          , Ms          , Ms          , Ms          , Ms          , Aa          , Aa          , Aa          , 2 Aa        , Aa          , Ms          , Ms          , Ms          , Ms          , Ms          , Aa          , Aa          , Aa          , Aa          , Aa          , Aa          , Aa          , Ms          , Ms          , Ms          , Ms          , Ms          , Ms          , Ms          , Aa          
Aa          , Aa          , Aa          , Aa          , Aa          , Ms          , Ms          , Ms          , Aa          , Ms          , Aa          , Aa          , Aa          , Ms          , Aa          , Aa          , Aa          , Ms          , Ms          , Ms          , Ms          , Ms          , Ms          , Ms          , Ms          , Ms          , Ms          , Aa          , Aa          , Aa          , Ms          , Ms          , Aa          , Aa          , Aa          , Ms          , Aa          , Ms          , Ms          , Ms          , Aa          , Aa          
Aa          , Aa          , Aa          , Aa          , Aa          , Aa          , Spay        , Aa          , Qxu         , Aa          , Spay        , Spay        , Aa          , Aa          , Aa          , Aa          , Aa          , Ms          , Ms          , Ms          , Aa          , Aa          , Aa          , Aa          , Aa          , Ms          , Ms          , Ms          , Aa          , Aa          , Aa          , Ms          , Aa          , Aa          , Aa          , Aa          , Aa          , Aa          , Aa          , Aa          , Aa          , Aa          
Aa          , Aa          , Aa          , Aa          , Aa          , Aa          , Aa          , Spay        , Spay        , Spay        , Aa          , Aa          , Ms          , Aa          , Aa          , Aa          , Aa          , Aa          , Aa          , Aa          , Aa          , Qxu         , Aa          , Aa          , Aa          , Ms          , Ms          , Ms          , Aa          , Aa          , Aa          , Aa          , Qxu         , Aa          , Aa          , Aa          , Aa          , Aa          , Aa          , Aa          , Aa          , Aa          
Aa          , Aa          , Aa          , Aa          , Ha          , Ha          , Ha          , Spay        , Aa          , Aa          , Ms          , Ms          , Ms          , Aa          , Aa          , Aa          , Aa          , Aa          , Aa          , Aa          , Aa          , Spay        , Aa          , Aa          , Ha          , Ha          , Ha          , Ha          , Ha          , Aa          , Aa          , Aa          , Spay        , Aa          , Aa          , Aa          , Ha          , Ha          , Ha          , Aa          , Ha          , Ha          
Aa          , Aa          , Aa          , Aa          , Aa          , Ha          , Aa          , Spay        , Aa          , Aa          , Aa          , Ms          , Aa          , Aa          , Ha          , Ms          , Ms          , Aa          , Aa          , Aa          , Aa          , Spay        , Aa          , Aa          , Aa          , Aa          , Aa          , Ha          , Aa          , Ha          , Aa          , Aa          , Uyi         , Aa          , Aa          , Ha          , Ha          , Ha          , Ha          , Ha          , Ha          , Ha          
Aa          , Aa          , Aa          , Aa          , Aa          , Aa          , Aa          , Spay        , Uyi         , Uyi^Ayb     , Uyi         , Aa          , Aa          , Ha          , Ha          , Ms          , Ms          , Ms          , Ms          , Aa          , Aa          , Spay        , Spay        , Aa          , Aa          , Aa          , Aa          , Aa          , Ms          , Aa          , Aa          , Aa          , Uyi^Ayb     , Uyi         , Spay        , Ha          , Aa          , Aa          , Aa          , Aa          , Aa          , Aa          
Aa          , Aa          , Ai          , Aa          , Aa          , Aa          , Aa          , Aa          , Aa          , Uyi         , Aa          , Spay        , Spay        , Ha          , Ha          , Aa          , Ms          , Ms          , Aa          , Aa          , Aa          , Aa          , Aa          , Spay        , Spay        , Aa          , Aa          , Ms          , Ms          , Ms          , Aa          , Aa          , Aa          , Uyi         , Spay        , Aa          , Aa          , Aa          , Aa          , Aa          , Aa          , Aa          
Aa          , Ai          , Ai          , Ai          , Aa          , Ms          , Ms          , Aa          , Aa          , Spay        , Aa          , Ha          , Ha          , Spay        , Aa          , Aa          , Aa          , Ms          , Aa          , Aa          , Aa          , Aa          , Aa          , Aa          , Spay        , Aa          , Aa          , Aa          , Ha          , Aa          , Aa          , Aa          , Aa          , Aa          , Spay        , Aa          , Aa          , Aa          , Aa          , Aa          , Aa          , Aa          
Uyi         , Aa          , Aa          , Ai          , Aa          , Ms          , Ms          , Ms          , Aa          , Spay        , Aa          , Aa          , Aa          , Spay        , Spay        , Aa          , Aa          , Aa          , Aa          , Aa          , Aa          , Aa          , Aa          , Aa          , Spay        , Aa          , Aa          , Ha          , Ha          , Ha          , Aa          , Aa          , Aa          , Aa          , Spay        , Aa          , Aa          , Aa          , Aa          , Aa          , Aa          , Aa          
Qxyi        , Uyi         , Aa          , Ai          , Ai          , Aa          , Aa          , Aa          , Aa          , Spay        , Spay        , Aa          , Aa          , Aa          , Aa          , Spay        , Spay        , Aa          , Aa          , Aa          , Aa          , Aa          , Aa          , Aa          , Spay        , Aa          , Aa          , Aa          , Aa          , Aa          , Aa          , Aa          , Ha          , Aa          , Spay        , Aa          , Aa          , Aa          , Aa          , Aa          , Aa          , Aa          
Qxyi        , Uyi         , Uyi         , Aa          , Aa          , Aa          , Aa          , Aa          , Aa          , Aa          , Spay        , Aa          , Aa          , Aa          , Aa          , Aa          , Aa          , Spay        , Aa          , Aa          , Aa          , Aa          , Aa          , Aa          , Spay        , Aa          , Aa          , Aa          , Aa          , Aa          , Aa          , Aa          , Ha          , Ha          , Spay        , Aa          , Aa          , Aa          , Aa          , Aa          , Aa          , Uyi         
Qxyi        , Qxyi        , Qxyi        , Uyi         , Aa          , Ha          , Ha          , Ha          , Ha          , Aa          , Spay        , Aa          , Aa          , Aa          , Aa          , Aa          , Aa          , Spay        , Spay        , Ha          , Uyi         , Uyi^Ayb     , Uyi         , Spay        , Aa          , Aa          , Aa          , Aa          , Aa          , Aa          , Ha          , Ha          , Ha          , Ha          , Spay        , Aa          , Aa          , Aa          , Aa          , Aa          , Uyi         , Uyi         
Qxyi        , Qxyi        , Qxyi        , Uyi         , Uyi         , Aa          , Ha          , Aa          , Ha          , Ha          , Aa          , Spay        , Aa          , Aa          , Aa          , Aa          , Aa          , Aa          , Aa          , Spay        , Spay        , Uyi         , Ha          , Ha          , Ha          , Ha          , Ha          , Ha          , Aa          , Aa          , Aa          , Aa          , Aa          , Aa          , Spay        , Aa          , Aa          , Aa          , Aa          , Uyi         , Qxyi        , Qxyi        
Qxyi        , Qxyi        , Qxyi        , Qxyi        , Uyi         , Aa          , Aa          , Ha          , Ha          , Ha          , Aa          , Spay        , Aa          , Aa          , Aa          , Aa          , Aa          , Aa          , Aa          , Aa          , Aa          , Spay        , Spay        , Ha          , Aa          , Ha          , Aa          , Ha          , Ha          , Aa          , Aa          , Aa          , Aa          , Spay        , Aa          , Aa          , Aa          , Aa          , Uyi         , Uyi         , Qxyi        , Qxyi        
Qxyi        , Qxyi        , Qxyi        , Qxyi        , Uyi         , Aa          , Aa          , Aa          , Aa          , Aa          , Aa          , Spay        , Spay        , Aa          , Aa          , Aa          , Aa          , Aa          , Aa          , Aa          , Aa          , Aa          , Aa          , Spay        , Spay        , Aa          , Aa          , Aa          , Aa          , Aa          , Aa          , Aa          , Aa          , Spay        , Aa          , Aa          , Aa          , Aa          , Uyi         , Qxyi        , Qxyi        , Qxyi        
Qxyi        , Qxyi        , Qxyi        , Qxyi        , Qxyi        , Uyi         , Aa          , Aa          , Aa          , Aa          , Aa          , Aa          , Spay        , Aa          , Aa          , Aa          , Aa          , Aa          , Ha          , Aa          , Aa          , Aa          , Aa          , Aa          , Aa          , Spay        , Aa          , Aa          , Aa          , Aa          , Aa          , Aa          , Spay        , Spay        , Aa          , Aa          , Aa          , Aa          , Uyi         , Qxyi        , Qxyi        , Qxyi        
Qxyi        , Qxyi        , Qxyi        , Qxyi        , Qxyi        , Uyi         , Aa          , Aa          , Aa          , Aa          , Aa          , Aa          , Spay        , Aa          , Aa          , Aa          , Aa          , Ha          , Ha          , Ha          , Ha          , Aa          , Aa          , Aa          , Aa          , Spay        , Aa          , Aa          , Aa          , Aa          , Spay        , Spay        , Aa          , Aa          , Aa          , Aa          , Aa          , Aa          , Uyi         , Qxyi        , Qxyi        , Qxyi        
Qxyi        , Qxyi        , Qxyi        , Qxyi        , Qxyi        , Uyi         , Uyi         , Aa          , Aa          , Aa          , Aa          , Aa          , Aa          , Spay        , Aa          , Aa          , Aa          , Ha          , Ha          , Ha          , Ha          , Aa          , Aa          , Aa          , Aa          , Uyi         , Uyi^Ayb     , Aa          , Spay        , Spay        , Aa          , Aa          , Aa          , Aa          , Aa          , Aa          , Aa          , Aa          , Uyi         , Qxyi        , Qxyi        , Qxyi        
Qxyi        , Qxyi        , Qxyi        , Qxyi        , Qxyi        , Qxyi        , Uyi         , Aa          , Aa          , Aa          , Aa          , Aa          , Aa          , Spay        , Aa          , Aa          , Aa          , Aa          , Aa          , Ha          , Aa          , Aa          , Aa          , Aa          , Aa          , Uyi         , Uyi         , Uyi         , Aa          , Aa          , Aa          , Aa          , Aa          , Aa          , Aa          , Aa          , Aa          , Uyi         , Qxyi        , Qxyi        , Qxyi        , Qxyi        
Qxyi        , Qxyi        , Qxyi        , Qxyi        , Qxyi        , Qxyi        , Uyi         , Aa          , Aa          , Aa          , Aa          , Aa          , Aa          , Spay        , Spay        , Aa          , Aa          , Aa          , Aa          , Aa          , Aa          , Aa          , Aa          , Aa          , Spay        , Spay        , Aa          , Aa          , Aa          , Aa          , Aa          , Aa          , Aa          , Aa          , Aa          , Aa          , Aa          , Uyi         , Qxyi        , Qxyi        , Qxyi        , Qxyi        
Qxyi        , Qxyi        , Qxyi        , Qxyi        , Qxyi        , Qxyi        , Uyi         , Aa          , Aa          , Aa          , Aa          , Aa          , Aa          , Aa          , Spay        , Aa          , Aa          , Aa          , Aa          , Aa          , Aa          , Aa          , Spay        , Spay        , Aa          , Aa          , Aa          , Aa          , Aa          , Aa          , Ha          , Aa          , Ha          , Aa          , Aa          , Aa          , Uyi         , Uyi         , Qxyi        , Qxyi        , Qxyi        , Qxyi        
Qxyi        , Qxyi        , Qxyi        , Qxyi        , Qxyi        , Qxyi        , Uyi         , Aa          , Aa          , Aa          , Aa          , Aa          , Aa          , Aa          , Spay        , Aa          , Aa          , Aa          , Aa          , Aa          , Spay        , Spay        , Aa          , Aa          , Aa          , Aa          , Aa          , Aa          , Aa          , Ha          , Aa          , Ha          , Aa          , Aa          , Aa          , Aa          , Uyi         , Qxyi        , Qxyi        , Qxyi        , Qxyi        , Qxyi        
Qxyi        , Qxyi        , Qxyi        , Qxyi        , Qxyi        , Qxyi        , Uyi         , Aa          , Aa          , Aa          , Aa          , Aa          , Aa          , Aa          , Ha          , Spay        , Uyi         , Uyi^Ayb     , Uyi         , Spay        , Aa          , Aa          , Aa          , Aa          , Aa          , Aa          , Aa          , Aa          , Aa          , Aa          , Aa          , Aa          , Aa          , Aa          , Aa          , Aa          , Uyi         , Qxyi        , Qxyi        , Qxyi        , Qxyi        , Qxyi        
Qxyi        , Qxyi        , Qxyi        , Qxyi        , Qxyi        , Qxyi        , Uyi         , Aa          , Aa          , Aa          , Aa          , Aa          , Aa          , Ha          , Ha          , Ha          , Spay        , Uyi         , Aa          , Aa          , Aa          , Aa          , Aa          , Aa          , Ha          , Aa          , Ha          , Ha          , Ha          , Ha          , Ha          , Ha          , Ha          , Ha          , Aa          , Aa          , Uyi         , Qxyi        , Qxyi        , Qxyi        , Qxyi        , Qxyi        
Qxyi        , Qxyi        , Qxyi        , Qxyi        , Qxyi        , Qxyi        , Uyi         , Aa          , Aa          , Aa          , Aa          , Aa          , Aa          , Ha          , Ha          , Ha          , Aa          , Spay        , Spay        , Aa          , Aa          , Aa          , Aa          , Ha          , Ha          , Ha          , Ha          , Ha          , Ha          , Ha          , Ha          , Ha          , Aa          , Aa          , Ai          , Aa          , Uyi         , Uyi         , Qxyi        , Qxyi        , Qxyi        , Qxyi        
Qxyi        , Qxyi        , Qxyi        , Qxyi        , Qxyi        , Qxyi        , Uyi         , Aa          , Aa          , Ai          , Ai          , Aa          , Aa          , Aa          , Aa          , Aa          , Aa          , Aa          , Spay        , Spay        , Spay        , Aa          , Aa          , Aa          , Aa          , Aa          , Aa          , Aa          , Aa          , Ha          , Aa          , Aa          , Ai          , Ai          , Aa          , Aa          , Uyi         , Qxyi        , Qxyi        , Qxyi        , Qxyi        , Qxyi        
Qxyi        , Qxyi        , Qxyi        , Qxyi        , Qxyi        , Qxyi        , Qxyi        , Uyi         , Aa          , Ai          , Ai          , Aa          , Aa          , Aa          , Aa          , Aa          , Aa          , Aa          , Spay        , Aa          , Aa          , Spay        , Aa          , Aa          , Aa          , Aa          , Aa          , Aa          , Aa          , Aa          , Aa          , Aa          , Ai          , Ai          , Aa          , Aa          , Uyi         , Qxyi        , Qxyi        , Qxyi        , Qxyi        , Qxyi        
Qxyi        , Qxyi        , Qxyi        , Qxyi        , Qxyi        , Qxyi        , Qxyi        , Uyi         , Aa          , Ai          , Ai          , Aa          , Aa          , Aa          , Aa          , Aa          , Ha          , Aa          , Spay        , Aa          , Aa          , Spay        , Spay        , Aa          , Aa          , Aa          , Aa          , Aa          , Aa          , Aa          , Aa          , Aa          , Aa          , Aa          , Aa          , Uyi         , Qxyi        , Qxyi        , Qxyi        , Qxyi        , Qxyi        , Qxyi        
Qxyi        , Qxyi        , Qxyi        , Qxyi        , Qxyi        , Qxyi        , Qxyi        , Uyi         , Aa          , Aa          , Aa          , Aa          , Aa          , Aa          , Aa          , Ha          , Ha          , Ha          , Spay        , Aa          , Aa          , Aa          , Aa          , Spay        , Spay        , Aa          , Aa          , Aa          , Aa          , Aa          , Aa          , Aa          , Aa          , Aa          , Aa          , Uyi         , Qxyi        , Qxyi        , Qxyi        , Qxyi        , Qxyi        , Qxyi        
Qxyi        , Qxyi        , Qxyi        , Qxyi        , Qxyi        , Qxyi        , Qxyi        , Uyi         , Uyi         , Aa          , Aa          , Aa          , Aa          , Aa          , Aa          , Aa          , Aa          , Aa          , Spay        , Aa          , Aa          , Aa          , Aa          , Aa          , Spay        , Aa          , Aa          , Aa          , Aa          , Aa          , Aa          , Aa          , Aa          , Aa          , Aa          , Uyi         , Qxyi        , Qxyi        , Qxyi        , Qxyi        , Qxyi        , Qxyi        
Qxyi        , Qxyi        , Qxyi        , Qxyi        , Qxyi        , Qxyi        , Qxyi        , Qxyi        , Uyi         , Aa          , Aa          , Aa          , Aa          , Aa          , Aa          , Aa          , Aa          , Spay        , Ai          , Aa          , Ai          , Ai          , Aa          , Aa          , Ha          , Spay        , Spay        , Aa          , Aa          , Aa          , Aa          , Aa          , Aa          , Aa          , Uyi         , Uyi         , Qxyi        , Qxyi        , Qxyi        , Qxyi        , Qxyi        , Qxyi        
Qxyi        , Qxyi        , Qxyi        , Qxyi        , Qxyi        , Qxyi        , Qxyi        , Qxyi        , Uyi         , Aa          , Aa          , Aa          , Aa          , Aa          , Aa          , Aa          , Aa          , Spay        , Ai          , Ai          , Ai          , Ai          , Aa          , Ha          , Ha          , Ha          , Spay        , Aa          , Aa          , Aa          , Aa          , Aa          , Aa          , Aa          , Uyi         , Qxyi        , Qxyi        , Qxyi        , Qxyi        , Qxyi        , Qxyi        , Qxyi        
Qxyi        , Qxyi        , Qxyi        , Qxyi        , Qxyi        , Qxyi        , Qxyi        , Qxyi        , Qxyi        , Uyi         , Aa          , Aa          , Aa          , Aa          , Aa          , Ha          , Ha          , Spay        , Aa          , Aa          , Aa          , Aa          , Aa          , Ha          , Spay        , Spay        , Aa          , Aa          , Aa          , Aa          , Aa          , Aa          , Aa          , Uyi         , Qxyi        , Qxyi        , Qxyi        , Qxyi        , Qxyi        , Qxyi        , Qxyi        , Qxyi        
Qxyi        , Qxyi        , Qxyi        , Qxyi        , Qxyi        , Qxyi        , Qxyi        , Qxyi        , Qxyi        , Uyi         , Aa          , Aa          , Aa          , Aa          , Aa          , Ha          , Aa          , Spay        , Aa          , Aa          , Aa          , Aa          , Spay        , Spay        , Aa          , Aa          , Aa          , Aa          , Aa          , Aa          , Aa          , Aa          , Uyi         , Uyi         , Qxyi        , Qxyi        , Qxyi        , Qxyi        , Qxyi        , Qxyi        , Qxyi        , Qxyi        
Qxyi        , Qxyi        , Qxyi        , Qxyi        , Qxyi        , Qxyi        , Qxyi        , Qxyi        , Qxyi        , Uyi         , Aa          , Aa          , Aa          , Aa          , Aa          , Aa          , Aa          , Spay        , Uyi         , Uyi^Ayb     , Uyi         , Spay        , Aa          , Aa          , Aa          , Aa          , Aa          , Aa          , Aa          , Aa          , Aa          , Aa          , Uyi         , Qxyi        , Qxyi        , Qxyi        , Qxyi        , Qxyi        , Qxyi        , Qxyi        , Qxyi        , Qxyi        
Qxyi        , Qxyi        , Qxyi        , Qxyi        , Qxyi        , Qxyi        , Qxyi        , Qxyi        , Qxyi        , Uyi         , Aa          , Aa          , Ai          , Aa          , Ha          , Aa          , Aa          , Aa          , Spay        , Spay        , Aa          , Aa          , Aa          , Aa          , Aa          , Aa          , Aa          , Aa          , Aa          , Aa          , Aa          , Aa          , Uyi         , Qxyi        , Qxyi        , Qxyi        , Qxyi        , Qxyi        , Qxyi        , Qxyi        , Qxyi        , Qxyi        
Qxyi        , Qxyi        , Qxyi        , Qxyi        , Qxyi        , Qxyi        , Qxyi        , Qxyi        , Qxyi        , Uyi         , Aa          , Ai          , Ai          , Ai          , Ha          , Aa          , Aa          , Aa          , Spay        , Ha          , Aa          , Aa          , Aa          , Ai          , Ai          , Aa          , Aa          , Aa          , Aa          , Aa          , Aa          , Uyi         , Qxyi        , Qxyi        , Qxyi        , Qxyi        , Qxyi        , Qxyi        , Qxyi        , Qxyi        , Qxyi        , Qxyi        
Qxyi        , Qxyi        , Qxyi        , Qxyi        , Qxyi        , Qxyi        , Qxyi        , Qxyi        , Qxyi        , Uyi         , Uyi         , Aa          , Ai          , Ai          , Aa          , Aa          , Spay        , Spay        , Spay        , Ha          , Aa          , Aa          , Aa          , Ai          , Ai          , Ai          , Aa          , Aa          , Aa          , Aa          , Uyi         , Uyi         , Qxyi        , Qxyi        , Qxyi        , Qxyi        , Qxyi        , Qxyi        , Qxyi        , Qxyi        , Qxyi        , Qxyi        
Qxyi        , Qxyi        , Qxyi        , Qxyi        , Qxyi        , Qxyi        , Qxyi        , Qxyi        , Qxyi        , Qxyi        , Uyi         , Aa          , Aa          , Aa          , Spay        , Spay        , Aa          , Aa          , Aa          , Spay        , Spay        , Spay        , Spay        , Aa          , Aa          , Aa          , Aa          , Aa          , Uyi         , Uyi         , Qxyi        , Qxyi        , Qxyi        , Qxyi        , Qxyi        , Qxyi        , Qxyi        , Qxyi        , Qxyi        , Qxyi        , Qxyi        , Qxyi        
Qxyi        , Qxyi        , Qxyi        , Qxyi        , Qxyi        , Qxyi        , Qxyi        , Qxyi        , Qxyi        , Qxyi        , Qxyi        , Uyi         , Uyi         , Uyi         , Uyi         , Ha          , Ha          , Aa          , Aa          , Spay        , Aa          , Aa          , Aa          , Spay        , Uyi         , Uyi         , Uyi         , Uyi         , Qxyi        , Qxyi        , Qxyi        , Qxyi        , Qxyi        , Qxyi        , Qxyi        , Qxyi        , Qxyi        , Qxyi        , Qxyi        , Qxyi        , Qxyi        , Qxyi        
Qxyi        , Qxyi        , Qxyi        , Qxyi        , Qxyi        , Qxyi        , Qxyi        , Qxyi        , Qxyi        , Qxyi        , Qxyi        , Qxyi        , Qxyi        , Qxyi        , Qxyi        , Uyi         , Uyi         , Uyi         , Uyi         , Uyi         , Uyi         , Uyi         , Uyi         , Uyi         , Qxyi        , Qxyi        , Qxyi        , Qxyi        , Qxyi        , Qxyi        , Qxyi        , Qxyi        , Qxyi        , Qxyi        , Qxyi        , Qxyi        , Qxyi        , Qxyi        , Qxyi        , Qxyi        , Qxyi        , Qxyi        
Qxyi        , Qxyi        , Qxyi        , Qxyi        , Qxyi        , Qxyi        , Qxyi        , Qxyi        , Qxyi        , Qxyi        , Qxyi        , Qxyi        , Qxyi        , Qxyi        , Qxyi        , Qxyi        , Qxyi        , Qxyi        , Qxyi        , Qxyi        , Qxyi        , Qxyi        , Qxyi        , Qxyi        , Qxyi        , 3 Qxyi      , Qxyi        , Qxyi        , Qxyi        , Qxyi        , Qxyi        , Qxyi        , Qxyi        , Qxyi        , Qxyi        , Qxyi        , Qxyi        , Qxyi        , Qxyi        , Qxyi        , Qxyi        , Qxyi        
Qxyi        , Qxyi        , Qxyi        , Qxyi        , Qxyi        , Qxyi        , Qxyi        , Qxyi        , Qxyi        , Qxyi        , Qxyi        , Qxyi        , Qxyi        , 1 Qxyi      , Qxyi        , Qxyi        , Qxyi        , Qxyi        , Qxyi        , Qxyi        , Qxyi        , Qxyi        , Qxyi        , Qxyi        , Qxyi        , Qxyi        , Qxyi        , Qxyi        , Qxyi        , Qxyi        , Qxyi        , Qxyi        , Qxyi        , Qxyi        , Qxyi        , Qxyi        , Qxyi        , Qxyi        , Qxyi        , Qxyi        , Qxyi        , Qxyi        
Qxyi        , Qxyi        , Qxyi        , Qxyi        , Qxyi        , Qxyi        , Qxyi        , Qxyi        , Qxyi        , Qxyi        , Qxyi        , Qxyi        , Qxyi        , Qxyi        , Qxyi        , Qxyi        , Qxyi        , Qxyi        , Qxyi        , Qxyi        , Qxyi        , Qxyi        , Qxyi        , Qxyi        , Qxyi        , Qxyi        , Qxyi        , Qxyi        , Qxyi        , Qxyi        , Qxyi        , Qxyi        , Qxyi        , Qxyi        , Qxyi        , Qxyi        , Qxyi        , Qxyi        , Qxyi        , Qxyi        , Qxyi        , Qxyi        
