border_size=1
usage=map

Mm          , Mm          , Mm          , Mm          , Mm          , Mm          , Mm          , Mm          , Mm          , Mm          , Mm          , Mm          , Mm          , Mm          , Mm          , Mm          , Mm          , Mm          , Mm          , Mm          , Mm          , Mm          , Mm          , Mm          , Mm          , Mm          , Mm          , Mm          , Mm          , Mm          , Mm          , Mm          , Mm          , Mm          , Mm          , Mm          , Mm          , Mm          , Mm          , Mm          , Mm          , Mm          , Mm          , Mm          , Mm          , Mm          
Mm          , Mm          , Mm          , Mm          , Mm          , Mm          , Mm          , Mm          , Mm          , Mm          , Mm          , Mm          , Mm          , Mm          , Mm          , Mm          , Mm          , Mm          , Mm          , Mm          , Mm          , Mm          , Mm          , Mm          , Mm          , Mm          , Mm          , Mm          , Mm          , Mm          , Mm          , Mm          , Mm          , Mm          , Mm          , Mm          , Mm          , Mm          , Mm          , Mm          , Mm          , Mm          , Mm          , Mm          , Mm          , Mm          
Hh          , Mm          , Hh          , Mm          , Hh          , Hh          , Hh          , Mm          , Mm          , Mm          , Mm          , Mm          , Mm          , Mm          , Mm          , Mm          , Hh          , Mm          , Mm          , Mm          , Mm          , Mm          , Mm          , Mm          , Mm          , Mm          , Hh^Fp       , Mm          , Mm          , Mm          , Mm          , Mm          , Mm          , Mm          , Mm          , Mm          , Mm          , Mm          , Mm          , Mm          , Mm          , Mm          , Mm          , Mm          , Mm          , Mm          
Hh          , Hh          , Hh          , Hh          , Hh          , Hh          , Hh          , Hh          , Hh          , Hh          , Hh          , Mm          , Hh          , Mm          , Hh          , Hh          , Gs          , Hh          , Hh          , Hh          , Hh          , Mm          , Hh^Fp       , Mm          , Hh^Fp       , Hh          , Hh^Fp       , Mm          , Hh^Fp       , Hh          , Hh          , Hh          , Hh          , Mm          , Mm          , Mm          , Hh          , Mm          , Mm          , Mm          , Mm          , Mm          , Mm          , Mm          , Mm          , Mm          
Gg          , Gg          , Gll^Fp      , Gg          , Gg          , Gg          , Gg          , Gg          , Gg          , Hh          , Gg          , Hh          , Hh          , Hh          , Gg          , Gg          , Gs          , Gg          , Gs          , Hh          , Hh          , Hh^Fp       , Hh^Fp       , Hh^Fp       , Hh^Fp       , Hh^Fp       , Gll^Fp      , Hh^Fp       , Hh^Fp       , Hh^Fp       , Gg          , Gg          , Gg          , Hh          , Hh          , Hh          , Cty         , Hh          , Hh          , Hh          , Mm          , Mm          , Mm          , Mm          , Mm          , Mm          
Ww          , Ww          , Ww          , Ww          , Ww          , Gg          , Gg          , Gll^Fp      , Gll^Fp      , Gll^Fp      , Gll^Fp      , Gg          , Gg          , Gg          , Gg          , Gg          , Gg          , Gs          , Gg          , Gg          , Hh          , Hh^Fp       , Gll^Fp      , Hh^Fp       , Gll^Fp      , Gll^Fp      , Gll^Fp      , Gll^Fp      , Gll^Fp      , Gg          , Gg          , Gg          , Gg          , Gg          , Gg          , Cty         , 2 Kty       , Cty         , Gg          , Hh          , Hh          , Mm          , Mm          , Mm          , Hh          , Hh          
Wwr         , Wwr         , Wwr         , Wwr         , Ww          , Ww          , Ww          , Gg          , Gg          , Gll^Fp      , Gll^Fp      , Gll^Fp      , Gg          , Gg          , Gg          , Gg          , Gs          , Gg          , Gg          , Hh          , Hh          , Gg          , Gg          , Gll^Fp      , Gll^Fp      , Gll^Fp      , Gll^Fp      , Gll^Fp      , Gll^Fp      , Gll^Fp      , Gll^Fp      , Gs^Vht      , Gll^Fp      , Gg          , Gll^Fp      , Cty         , Cty         , Cty         , Gg          , Gg          , Gg          , Hh          , Hh          , Hh          , Hh          , Hh          
Wo          , Wwr         , Ww          , Ww          , Ww          , Ww          , Ww          , Ww          , Ww          , Gll^Fp      , Gll^Fp      , Gll^Fp      , Gg          , Gg          , Gg          , Gs          , Gs          , Gs          , Gg          , Gg          , Gg          , Gg          , Gg          , Gg          , Gg          , Gll^Fp      , Gll^Fp      , Gll^Fp      , Gll^Fp      , Gll^Fp      , Gll^Fp      , Gll^Fp      , Gg          , Gll^Fp      , Gll^Fp      , Gll^Fp      , Gll^Fp      , Gll^Fp      , Gll^Fp      , Gg          , Gg          , Gg          , Gg          , Gg          , Gg          , Gg          
Wo          , Wo          , Wo          , Wo          , Wo          , Ww          , Ww          , Ww          , Ww          , Ww          , Ww          , Ds          , Ds          , Ds          , Ds          , Gg          , Gg          , Gs          , Gg          , Gg          , Gg          , Gg          , Gs^Vc       , Gg          , Gg          , Hh          , Mm          , Gll^Fp      , Hh          , Hh^Fp       , Hh^Fp       , Gll^Fp      , Gg          , Gll^Fp      , Gll^Fp      , Gll^Fp      , Gg          , Gll^Fp      , Gg          , Gg          , Gll^Fp      , Gg          , Gs^Vht      , Gg          , Gll^Fp      , Gg          
Ww          , Wo          , Ww          , Ww          , Ww          , Wo          , Wo          , Wo          , Wo          , Ww          , Ww          , Ww          , Ww          , Ww          , Ww          , Ds          , Ds          , Gg          , Gg          , Gg          , Gg          , Gg          , Gg          , Gg          , Gg          , Hh          , Mm          , Mm          , Mm          , Hh          , Hh          , Hh^Fp       , Gll^Fp      , Gg          , Gg          , Gg          , Gll^Fp      , Gg          , Gll^Fp      , Gll^Fp      , Gll^Fp      , Gll^Fp      , Gll^Fp      , Gll^Fp      , Gll^Fp      , Gll^Fp      
Ds          , Ds          , Ds          , Ww          , Ds          , Ww          , Ww          , Ww          , Ww          , Wo          , Ww          , Ww          , Ww          , Ww          , Wwr         , Ww          , Ww          , Ds          , Ds          , Gg          , Gg          , Gg          , Gg          , Gg          , Gg          , Hh          , Hh          , Mm          , Hh^Fp       , Hh          , Hh^Fp       , Gll^Fp      , Gg          , Gg          , Gg          , Gll^Fp      , Gll^Fp      , Gll^Fp      , Gll^Fp      , Gll^Fp      , Gll^Fp      , Gll^Fp      , Gll^Fp      , Gll^Fp      , Gll^Fp      , Gll^Fp      
Rb          , Rb          , Rb          , Ds          , Gg          , Ds          , Ds          , Ww          , Ds          , Ww          , Ww          , Ww          , Ww          , Wwr         , Ww          , Wwr         , Ww          , Ww          , Ww          , Ds          , Gg          , Gll^Fp      , Gll^Fp      , Gg          , Gs          , Gs          , Gg          , Hh          , Gll^Fp      , Gll^Fp      , Gll^Fp      , Gll^Fp      , Gg          , Gg          , Gg          , Gll^Fp      , Hh^Fp       , Hh^Fp       , Gll^Fp      , Gll^Fp      , Gll^Fp      , Gll^Fp      , Gll^Fp      , Gll^Fp      , Gll^Fp      , Gll^Fp      
Rb          , Rb          , Rb          , Gg          , Rb          , Gg          , Gg          , Ds          , Gg          , Ds          , Ds          , Ds          , Ds          , Ww          , Ww          , Ww          , Wo          , Ww          , Ww          , Ww          , Ww          , Gg          , Gg          , Gg          , Gs          , Gs          , Gg          , Gg          , Gg          , Gll^Fp      , Gll^Fp      , Gll^Fp      , Gg          , Gg          , Mm          , Hh          , Hh          , Hh^Fp       , Hh^Fp       , Gll^Fp      , Gll^Fp      , Gll^Fp      , Gll^Fp      , Gll^Fp      , Gg          , Gg          
Gll^Fp      , Rb          , Gg          , Rb          , Rb          , Rb          , Rb          , Gg          , Rb          , Gg          , Gg          , Gg          , Gg          , Ds          , Ds          , Ww          , Wo          , Wo          , Wo          , Wo          , Ww          , Ww          , Ss          , Gg          , Gs          , Gs          , Gd          , Gg          , Gg          , Gg          , Gg          , Gg          , Gg          , Hh          , Hh          , Hh          , Gg          , Gll^Fp      , Gll^Fp      , Gll^Fp      , Gll^Fp      , Gg          , Gg          , Gg          , Gg          , Gg          
Gll^Fp      , Gll^Fp      , Gll^Fp      , Gg          , Gg          , Gg          , Gg          , Rb          , Rb          , Rb          , Rb          , Gg          , Gg          , Gg          , Gg          , Ds          , Ds          , Ww          , Ww          , Wo          , Wo          , Ww          , Ww          , Gg          , Gs          , Gd          , Gd          , Gd          , Gs          , Gg          , Gg          , Gg          , Gg          , Gg          , Rb          , Gg          , Gg          , Gll^Fp      , Gll^Fp      , Gll^Fp      , Gg          , Gg          , Gg          , Gg          , Gg          , Gg          
Gg          , Gll^Fp      , Gg          , 4 Gg        , Gg          , Gg          , Gg          , Gg          , Gg          , Rb          , Rb          , Rb          , Rb          , Gg          , Gg          , Gg          , Ds          , Ww          , Ww          , Ww          , Wo          , Ww          , Ww          , Gg          , Gll^Fp      , Gs          , Gs          , Gs          , Gg          , Chr         , Gg          , Gg          , Gg          , Rb          , Gg          , Gg          , Gg          , Rb          , Gg          , Gg          , Gg          , Gg          , Gs^Vc       , Gg          , Gg          , Gg          
Gg          , Gg          , Gg          , Gg          , Gg          , Gg          , Gg          , Gg          , Gg          , Gg          , Gg          , Gg          , Gg          , Rb          , Rb          , Gg          , Ds          , Ww          , Ww          , Ww          , Wo          , Ww          , Ww          , Gg          , Gll^Fp      , Hh^Fp       , Rb          , Gs          , Rb          , Rb          , Rb          , Gg          , Hh          , Hh          , Hh          , Gg          , Gg          , Gg          , Gg          , Gg          , Gg          , Gs          , Gg          , Gg          , Gg          , Gg          
Gs          , Gg          , Gg          , Gs^Vc       , Gg          , Gg          , Gg          , Hh          , Hh          , Hh          , Hh          , Gg          , Gg          , Gg          , Rb          , Gg          , Gg          , Ds          , Ww          , Ww          , Ww          , Ww          , Ww          , Gg          , Gg          , Hh          , Hh          , Rb          , Rb          , Rb          , Rb          , Gg          , Hh^Fp       , Hh^Fp       , Hh^Fp       , Gll^Fp      , Gll^Fp      , Gll^Fp      , Gll^Fp      , Gg          , Gg          , Gs          , Gs          , Gg          , Gg          , Gg          
Gll^Fp      , Gg          , Gs          , Gg          , Gs          , Gg          , Gs          , Hh          , Gg          , Mm          , Mm          , Hh          , Gg          , Gg          , Rb          , Rb          , Gg          , Ds          , Ww          , Ww          , Ww          , Ww          , Ww          , Ss          , Gg          , Hh          , Gg          , Rb          , Rb          , Rb          , Gg          , Gg          , Gg          , Hh^Fp       , Hh^Fp       , Gll^Fp      , Gll^Fp      , Gll^Fp      , Gll^Fp      , Gg          , Gg          , Gg          , Gs          , Gg          , Gg          , Gg          
Gd          , Gs          , Gd          , Gs          , Gs          , Gs          , Gg          , Gs          , Gs          , Hh          , Hh          , Hh          , Gg          , Gg          , Gg          , Rb          , Gg          , Ds          , Ds          , Ww          , Ww          , Wwr         , Ww          , Ww          , Ww          , Gg          , Gg          , Rb          , Rb          , Gg          , Gg          , Gg          , Gll^Fp      , Gll^Fp      , Gll^Fp      , Gll^Fp      , Gll^Fp      , Gll^Fp      , Gg          , Gg          , Gs          , Gg          , Gg          , Gg          , Gg          , Gg          
Gs          , Gd          , Gs          , Gs          , Gg          , Gg          , Gg          , Gg          , Gg          , Gs          , Gg          , Hh          , Gg          , Gg          , Gg          , Rb          , Gg          , Gg          , Gg          , Ds          , Ww          , Ww          , Ww          , Ww          , Wwf         , Wwf         , Wwf         , Gg          , Gg          , Gg          , Gg          , 5 Gg        , Gll^Fp      , Gll^Fp      , Gll^Fp      , Gll^Fp      , Gll^Fp      , Gg          , Gg          , Gg          , Gg          , Gs          , Gg          , Gg          , Gg          , Gg          
Gs          , Gs          , Gg          , Hh          , Hh          , Gg          , Gs          , Gg          , Gs          , Gs          , Gg          , Gg          , Gg          , Gg          , Gg          , Rb          , Rb          , Gg          , Gg          , Ds          , Ww          , Ww          , Wwr         , Ww          , Wwf         , Wwf         , Wwf         , Wwf         , Ss          , Gg          , Ss          , Ss          , Ss          , Gll^Fp      , Ss          , Gll^Fp      , Ss          , Gg          , Gg          , Gg          , Gg          , Gg          , Gg          , Gg          , Ss          , Ss          
Gll^Fp      , Gll^Fp      , Gs          , Hh^Fp       , Hh^Fp       , Gs          , Gg          , Gs          , Gg          , Gg          , Gg          , Ce          , Gg          , Gg          , Gg          , Gg          , Rb          , Rb          , Rb          , Gg          , Wwf         , Wwf         , Wwf         , Wwf         , Wwr         , Wwr         , Wwr         , Ww          , Ww          , Ww          , Ww          , Ww          , Ss          , Ss          , Ss          , Ss          , Ss          , Ss          , Ss          , Gg          , Ss          , Gg          , Ss          , Ss          , Ss          , Ss          
Gll^Fp      , Gll^Fp      , Gll^Fp      , Gll^Fp      , Gll^Fp      , Gll^Fp      , Gg          , Gg          , Gs          , Gg          , Ce          , Gg          , Gg          , Re^Vct      , Gg          , Gg          , Gg          , Rb          , Rb          , Rb          , Wwf         , Wwf         , Ww          , Ww          , Ww          , Wwr         , Ww          , Ww          , Wo          , Wo          , Wo          , Ww          , Ww          , Ww          , Ww          , Ww          , Ww          , Ss          , Ww          , Ss          , Ww          , Ss          , Ww          , Ww          , Ww          , Ww          
Gll^Fp      , Gll^Fp      , Gd          , Gll^Fp      , Gs          , Gd          , Gs          , Gs          , Gg          , Gg          , Gg          , Gg          , Ce          , Gg          , Ce          , Ce          , Gg          , Rb          , Rb          , Rb          , Rb          , Wwf         , Ss          , Ww          , Ds          , Ww          , Ww          , Wo          , Wo          , Wo          , Wo          , Wo          , Wo          , Ww          , Wwr         , Wwr         , Wwr         , Ww          , Wo          , Wo          , Wo          , Ww          , Wo          , Ww          , Wwr         , Wwr         
Gs          , Gs          , Gs          , Gs          , Gs          , Gs          , Gs          , Gs          , Gg          , Gg          , Gg          , Gg          , Gg          , Ce          , 1 Ke        , Gg          , Ce          , Gg          , Gg          , Rb          , Hh          , Gg          , Gg          , Gg          , Gg          , Ds          , Ds          , Ww          , Ds          , Ww          , Ww          , Wo          , Ww          , Ww          , Ww          , Wwr         , Ww          , Ww          , Ww          , Wo          , Ww          , Wo          , Wo          , Wo          , Wo          , Wo          
Mm          , Gg          , Gg          , Gg          , Gg          , Gs          , Gs          , Gs          , Gg          , Gg          , Gg          , Gg          , Gg          , Ce          , Gg          , Gg          , Ce          , Gg          , Gg          , Rb          , Rb          , Hh          , Gg          , Gg          , Gg          , Gg          , Gg          , Ds          , Gg          , Ds          , Ss          , Ww          , Ss^Vhs      , Ww          , Ww          , Ww          , Ss          , Ww          , Ww          , Ww          , Ww          , Wo          , Wo          , Wo          , Wo          , Wo          
Mm          , Mm          , Mm          , Gg          , Gg          , Gg          , Gg          , Gg          , Gg          , Gg          , Gg          , Re^Vct      , Gg          , Gg          , Gg          , Ce          , Gg          , 3 Ke        , Gg          , Gg          , Gg          , Rb          , Gg          , Gs          , Gs          , Gs          , Gs          , Gg          , Gg          , Gg          , Gg          , Ss          , Ss          , Ss          , Gg          , Gg          , Gg          , Gg          , Gg          , Ww          , Ww          , Ww          , Ww          , Ww          , Wwr         , Wo          
Mm          , Mm          , Mm          , Gg          , Gg          , Gg          , Gg          , Gg          , Gg          , Gg          , Gll^Fp      , Gg          , Gg          , Ce          , Gg          , Gg          , Gg          , Ce          , Gg          , Re^Vct      , Gg          , Rb          , Gs          , Gs          , Gd          , Gd          , Gd          , Gs          , Gg          , Gg          , Gg          , Gg          , Rb          , Gg          , Rb          , Gg          , Rb          , Gg          , Gg          , Gg          , Gg          , Gg          , Gg          , Ww          , Ww          , Wwr         
Mm          , Mm          , Mm          , Mm          , Mm          , Gg          , Gg          , Gg          , Gg          , Hh          , Hh          , Gll^Fp      , Gg          , Gg          , Gg          , Re^Vct      , Gg          , Gg          , Ce          , Gg          , Gg          , Rb          , Rb          , Gs          , Gs          , Gd          , Gs          , Gs          , Gs          , Gs          , Gg          , Gg          , Gg          , Rb          , Gg          , Rb          , Rb          , Rb          , Rb          , Gg          , Gg          , Gg          , Gs^Vc       , Gs          , Gs          , Gs          
Mm          , Mm          , Mm          , Mm          , Mm          , Mm          , Mm          , Gg          , Hh          , Hh          , Hh          , Gg          , Hhd         , Gg          , Hhd         , Gg          , Gg          , Gg          , Gs          , Gg          , Gg          , Gg          , Rb          , Rb          , Rb          , Gs          , Rb          , Gs          , Gg          , Gg          , Gll^Fp      , Gg          , Gll^Fp      , Gg          , Gs          , Gs          , Gg          , Rb          , Rb          , Rb          , Rb          , Gg          , Gg          , Gs          , Gs          , Gs          
Mm          , Mm          , Mm          , Mm          , Mm          , Mm          , Mm          , Mm          , Mm          , Hh          , Hh          , Hh          , Hhd         , Hhd         , Hhd         , Gg          , Gg          , Gg          , Gs          , Gs          , Gs          , Gg          , Gg          , Rb          , Rb          , Rb          , Chr         , Gg          , Gg          , Gll^Fp      , Gll^Fp      , Gll^Fp      , Gll^Fp      , Gll^Fp      , Gll^Fp      , Gs          , Gg          , Gg          , Gg          , Rb          , Rb          , Rb          , Rb          , Gg          , Gg          , Gs          
Mm          , Mm          , Mm          , Mm          , Mm          , Mm          , Mm          , Mm          , Mm          , Mm          , Mm          , Mm          , Mm          , Mm          , Mm          , Hhd         , Hhd         , Gg          , Gs          , Gs          , Gs          , Gg          , Gd          , Gg          , Gg          , Gg          , Gg          , Gg          , Gg          , Gll^Fp      , Gll^Fp      , Gll^Fp      , Gll^Fp      , Gll^Fp      , Gll^Fp      , Gll^Fp      , Gll^Fp      , Gg          , Hhd         , Hhd         , Hhd         , Rb          , Rb          , Rb          , Rb          , Gg          
Mm          , Mm          , Mm          , Mm          , Mm          , Mm          , Mm          , Mm          , Mm          , Mm          , Mm          , Mm          , Mm          , Mm          , Mm          , Mm          , Hhd         , Hhd         , Gd          , Gs          , Gd          , Gd          , Gd          , Gd          , Gg          , Gg          , Gg          , Gg          , Gll^Fp      , Gll^Fp      , Gll^Fp      , Gll^Fp      , Gll^Fp      , Gll^Fp      , Hh^Fp       , Hh^Fp       , Hh^Fp       , Hh^Fp       , Hh^Fp       , Hhd         , Gs          , Gg          , Rb          , Rb          , Rb          , Rb          
Mm          , Mm          , Mm          , Mm          , Mm          , Mm          , Mm          , Mm          , Mm          , Mm          , Mm          , Mm          , Mm          , Mm          , Mm          , Mm          , Hhd         , Hhd         , Gg          , Gd          , Gd          , Gd          , Gd          , Gs          , Gs          , Gg          , Gg          , Gg          , Gll^Fp      , Gll^Fp      , Gll^Fp      , Gll^Fp      , Gll^Fp      , Hh^Fp       , Hh^Fp       , Hh^Fp       , Hh^Fp       , Hh^Fp       , Hh^Fp       , Gll^Fp      , Gg          , Gg          , Gg          , Rb          , Rb          , Rb          
