border_size=1
usage=map

Mm          , Mm          , Mm          , Mm          , Mm          , Mm          , Mm          , Mm          , Mm          , Mm          , Mm          , Mm          , Mm          , Mm          , Mm          , Mm          , Mm          , Mm          , Mm          , Mm          , Mm          , Mm          , Mm          , Mm          , Mm          , Mm          , Mm          , Mm          , Mm          , Mm          
Mm          , Mm          , Mm          , Mm          , Hh          , Mm          , Mm          , Mm          , Mm          , Mm          , Mm          , Mm          , Mm          , Mm          , Mm          , Mm          , Mm          , Mm          , Mm          , Mm          , Hh          , Mm          , Mm          , Mm          , Mm          , Mm          , Mm          , Mm          , Mm          , Mm          
Mm          , Mm          , Mm          , Hh          , Re          , Hh          , Mm          , Mm          , Mm          , Mm          , Mm          , Mm          , Mm          , Mm          , Mm          , Mm          , Mm          , Mm          , Re          , Hh          , Hh          , Hh          , Mm          , Mm          , Mm          , Mm          , Mm          , Mm          , Mm          , Mm          
Mm          , Mm          , Mm          , Re          , Re          , Hh          , Hh          , Hh          , Hh          , Hh          , Hh          , Mm          , Mm          , Mm          , Hh          , Mm          , Gg          , Gg          , Re          , Re          , Hh          , Hh          , Hh          , Hh          , Hh          , Mm          , Mm          , Mm          , Mm          , Mm          
Mm          , Mm          , Hh          , Hh          , Hh          , Mm          , Hh          , Hh          , Cpy         , Cpy         , Cpy         , Re          , Mm          , Hh          , Hh          , Hh          , Gg          , 2 Gg        , Gg          , Gg          , Mm          , Mm          , Hh          , Gg          , Gg          , Mm          , Mm          , Mm          , Mm          , Mm          
Mm          , Mm          , Hh          , Hh          , Hh          , Mm          , Hh          , Hh          , Cpy         , 3 Kpy       , Cpy         , Re          , Gg          , Re          , Re          , Hh          , Gg          , Gg          , Re          , Mm          , Hh          , Mm          , Mm          , Gg          , Mm          , Mm          , Mm          , Mm          , Mm          , Mm          
Mm          , Mm          , Mm          , Hh          , Hh          , Hh          , Hh          , Hh          , Re          , Cpy         , Re          , Re          , Gg          , Mm          , Mm          , Mm          , Gg          , Gg          , Gg          , Re          , Hh          , Hh          , Mm          , Mm          , Mm          , Mm          , Mm          , Mm          , Mm          , Mm          
Mm          , Mm          , Gg          , 4 Gg        , Hh          , Hh          , Hh          , Hh          , Gg          , Re          , Mm          , Gg          , Gg          , Mm          , Mm          , Mm          , Gg          , Gg          , Gg          , Re          , Hh          , Hh          , Mm          , Mm          , Mm          , Mm          , Mm          , Mm          , Mm          , Mm          
Mm          , Mm          , Gg          , Gg          , Gg          , Gg^Vypr     , Gg          , Gg          , Mm          , Mm          , Mm          , Gg          , Gg^Vypr     , Gg          , Mm          , Mm          , Mm          , Gg          , Hh          , Gg          , Hh          , Mm          , Mm          , Mm          , Mm          , Mm          , Mm          , Mm          , Mm          , Mm          
Mm          , Mm          , Gg          , Gg          , Gg          , Gg          , Gg          , Gg          , Mm          , Mm          , Mm          , Gg          , Gg          , Gg          , Mm          , Mm          , Mm          , Hh          , Hh          , Hh          , Hh          , Hh          , Mm          , Mm          , Mm          , Mm          , Mm          , Mm          , Mm          , Mm          
Mm          , Gg          , Gg          , Gg          , Mm          , Gg          , Gg          , Gg          , Hh          , Hh          , Hh          , Mm          , Mm          , Mm          , Mm          , Mm          , Mm          , Hh          , Hh          , Hh          , Hh          , Hh          , Mm          , Mm          , Mm          , Mm          , Mm          , Mm          , Mm          , Mm          
Mm          , Gg          , Gg          , Gg          , Mm          , Mm          , Gg          , Mm          , Gg          , Hh          , Hh          , Mm          , Gg          , Gg          , Mm          , Mm          , Re          , Re          , Gg          , Gg          , Hh          , Mm          , Mm          , Mm          , Mm          , Mm          , Mm          , Mm          , Mm          , Mm          
Mm          , Mm          , Gg          , Mm          , Mm          , Gg          , Hh          , Gg          , Gg          , Gg          , Gg          , Gg          , Hh          , Gg          , Hh          , Re          , Hh          , Hh          , Hh          , Hh          , Hh          , Hh          , Hh          , Gg          , Hh          , Gg          , Mm          , Mm          , Mm          , Mm          
Mm          , Mm          , Gg          , Gg          , Gg          , Gg          , Hh          , Hh          , Hh          , Gg          , Hh          , Hh          , Hh          , Hh          , Hh          , Hh          , Hh          , Hh          , Hh          , Hh          , Gll^Fp      , Hh          , Hh          , Hh          , Hh          , Hh          , Gg          , Mm          , Mm          , Mm          
Mm          , Gg          , Hh          , Hh          , Hh          , Hh          , Gll^Fp      , Gg          , Gg          , Hh          , Hh          , Hh          , Hh          , Hh          , Gg          , Gg          , Gg          , Hh          , Gg          , Gll^Fp      , Gll^Fp      , Gll^Fp      , Hh          , Hh          , Hh          , Hh          , Hh          , Gg          , Mm          , Mm          
Mm          , Hh          , Hh          , Hh          , Hh          , Gll^Fp      , Gll^Fp      , Gg          , Hh          , Hh          , Hh          , Hh          , Gg          , Gg          , Gg          , Gg          , Gg          , Gg          , Gg          , Gg          , Hh          , Hh          , Hh          , Mm          , Mm          , Hh          , Hh          , Gg          , Mm          , Mm          
Mm          , Hh          , Hh          , Hh          , Hh          , Hh          , Hh          , Gll^Fp      , Hh          , Hh          , Hh          , Hh          , Re          , Gg          , Gg          , Gg          , Gg          , Gg          , Gg          , Gg          , Gg          , Hh          , Hh          , Hh          , Mm          , Mm          , Mm          , Gg          , Mm          , Mm          
Mm          , Hh          , Mm          , Mm          , Gg          , Hh          , Hh          , Hh          , Hh          , Hh          , Hh          , Hh          , Uu          , Re          , Re          , Hh          , Hh          , Gg          , Gg          , Gg          , Gg          , Hh          , Hh          , Hh          , Hh          , Mm          , Mm          , Mm          , Mm          , Mm          
Mm          , Mm          , Mm          , Gg          , Gg          , Gg          , Hh          , Hh          , Hh          , Hh          , Hh          , Uu          , Uu          , Uu          , Re          , Hh          , Hh          , Hh          , Gg          , Gg          , Gg          , Hh          , Hh          , Hh          , Hh          , Hh          , Mm          , Mm          , Mm          , Mm          
Mm          , Mm          , Gg          , Gg          , Gg          , Gg          , Hh          , Hh          , Hh          , Re          , Re          , Uu          , Uu          , Uu          , Hh          , Hh          , Gg          , Hh          , Gg          , Gg          , Gg          , Hh          , Hh          , Hh          , Gg          , Hh          , Hh          , Mm          , Mm          , Mm          
Mm          , Mm          , Gg          , Gg          , Gg          , Hh          , Hh          , Hh          , Hh          , Hh          , Hh          , Re          , Re          , Re          , Hh          , Gg          , Gg          , Gg          , Gg          , Gg          , Hh          , Gll^Fp      , Gll^Fp      , Gg          , Gg          , Hh          , Hh          , Gg          , Mm          , Mm          
Mm          , Gg          , Gg          , Gg          , Hh          , Hh          , Gg          , Hh          , Hh          , Hh          , Gg          , Gg          , Gg          , Re          , Gg          , Gg          , Gg          , Gg          , Gg          , Hh          , Hh          , Gll^Fp      , Gll^Fp      , Gll^Fp      , Gg          , Gg          , Hh          , Hh          , Mm          , Mm          
Mm          , Gg          , Gg          , Gg          , Hh          , Re          , Gg          , Gg          , Hh          , Hh          , Gg          , Gg          , Gg          , Gg          , Gg          , Gg          , Gg          , Gg          , Gg          , Hh          , Gg          , Hh          , Gll^Fp      , Hh          , Hh          , Hh          , Hh          , Hh          , Mm          , Mm          
Mm          , Gg          , Gg          , Gg          , Gg          , Re          , Re          , Gg          , Hh          , Hh          , Gll^Fp      , Gll^Fp      , Gll^Fp      , Gg          , Gg          , Gg          , Gg          , Gg          , Gg          , Gg          , Gg          , Gg          , Hh          , Hh          , Re          , Hh          , Hh          , Hh          , Gg          , Mm          
Mm          , Gg          , Gg          , Gg          , Gg          , Hh          , Hh          , Hh          , Hh          , Gg          , Gg          , Gll^Fp      , Gg          , Gg          , Gg          , Gg          , Gg          , Gg          , Gg          , Gg          , Gg          , Gg          , Hh          , Re          , Re          , Re          , Hh          , Hh          , Mm          , Mm          
Mm          , Gg          , Gg          , Gg          , Hh          , Hh          , Hh          , Hh          , Gg          , Gg          , Gg          , Gg          , Gg          , Gg          , Re          , Gg          , Gg          , Gg          , Gg^Vypr     , Gg          , Gg          , Gg          , Gg          , Hh          , Hh          , Hh          , Hh          , Hh          , Gg          , Mm          
Mm          , Gg          , Gg          , Gg          , Hh          , Hh          , Hh          , Gg          , Gg          , Gg^Vypr     , Gg          , Gg          , Re          , Re          , Cpy         , Re          , Re          , Gg          , Gg          , Gg          , Gg          , Gg          , Gg          , Gg          , Gg          , Hh          , Hh          , Hh          , Hh          , Mm          
Mm          , Gg          , Gg          , Gg          , Hh          , Hh          , Hh          , Gg          , Gg          , Gg          , Gg          , Gg          , Re          , Cpy         , Kpy         , Cpy         , Re          , Gg          , Gg          , Gg          , Gg          , Gg          , Gg          , Gg          , Gg          , Gg          , Gg          , Hh          , Hh          , Mm          
Mm          , Mm          , Gg          , Gg          , Gg          , Hh          , Hh          , Gg          , Gg          , Gg          , Gg          , Gg          , Re          , Cpy         , Cpy         , Cpy         , Re          , Gg          , Gg          , Hh          , Hh          , Gg          , Gg          , Gg          , Gg          , Gg          , Re          , Re          , Hh          , Mm          
Mm          , Gg          , Gg          , Gg          , Gg          , Hh          , Hh          , Gg          , Gg          , Gg          , Gg          , Gg          , Gg          , Re          , Re          , Re          , Gg          , Gg          , Gg          , Hh          , Hh          , Gg          , Gg          , Gg          , Gg          , Gg          , Gg          , Re          , Hh          , Mm          
Mm          , Gg          , Gg          , Gg          , Hh          , Hh          , Hh          , Gg          , Gg          , Gg          , Gg          , Gg          , Gg          , Gg          , Gg          , Gg          , Gg          , Gg          , Gg          , Hh          , Hh          , Gg          , Gg          , Gg          , Gg          , Gg          , Gg          , Gg          , Hh          , Mm          
Xu          , Mm          , Hh          , Hh          , Hh          , Hh          , Hh          , Hh          , Hh          , Gg          , Gg          , Gg          , Gg          , Gg          , Gg          , Gg          , Gg          , Gg          , Gg          , Gg          , Gg          , Gg          , Gg          , Gg          , Gg          , Gg          , Hh          , Hh          , Mm          , Mm          
Xu          , Xu          , Xu          , Xu          , Xu          , Xu          , Xu          , Xu          , Xu          , Xu          , Xu          , Xu          , Xu          , Xu          , Xu          , Xu          , Xu          , Gg          , Xu          , Gg          , Xu          , Gg          , Gg          , Gg          , Gg          , Gg          , Hh          , Hh          , Xu          , Xu          
Xu          , Xu          , Xu          , Xu          , Xu          , Xu          , Xu          , Xu          , Xu          , Xu          , Xyui        , Xyui        , Xyui        , Xyui        , Xyui        , Xyui        , Xyui        , Xu          , Xu          , Xu          , Xu          , Xu          , Xu          , Xu          , Xu          , Xu          , Xu          , Xu          , Xu          , Xu          
Xu          , Xu          , Xyui        , Xu          , Xyui        , Xyui        , Xyui        , Xyui        , Xyui        , Xyui        , Xyui        , Xyui        , Xyui        , Xyui        , Xyui        , Xyui        , Xyui        , Xyui        , Xyui        , Xu          , Xu          , Xu          , Xu          , Xu          , Xu          , Xu          , Xu          , Xu          , Xu          , Xu          
Xyui        , Xyui        , Xyui        , Xyui        , Xyui        , Xyui        , Xyui        , Xyui        , Xyui        , Xyui        , Xyui        , Xyui        , Qxyi        , Xyui        , Qxyi        , Xyui        , Xyui        , Xyui        , Xyui        , Xyui        , Xyui        , Xyui        , Xyui        , Xyui        , Xyui        , Xyui        , Xyui        , Xyui        , Xyui        , Xu          
Xyui        , Xyui        , Xyui        , Xyui        , Xyui        , Xyui        , Xyui        , Xyui        , Xyui        , Xyui        , Qxyi        , Qxyi        , Qxyi        , Qxyi        , Qxyi        , Qxyi        , Qxyi        , Xyui        , Xyui        , Xyui        , Xyui        , Xyui        , Xyui        , Xyui        , Xyui        , Xyui        , Xyui        , Xyui        , Xyui        , Xyui        
Xyui        , Xyui        , Xyui        , Xyui        , Xyui        , Xyui        , Xyui        , Xyui        , Qxyi        , Qxyi        , Qxyi        , Qxyi        , Qxyi        , Qxyi        , Qxyi        , Qxyi        , Qxyi        , Uyi         , Uyi         , Uyi         , Uyi         , Uyi         , Xyui        , Xyui        , Uyi         , Xyui        , Aa          , Xyui        , Xyui        , Xyui        
Xyui        , Xyui        , Xyui        , Xyui        , Xyui        , Xyui        , Uyi         , Xyui        , Qxyi        , Qxyi        , Qxyi        , Qxyi        , Qxyi        , Qxyi        , Qxyi        , Qxyi        , Qxyi        , Qxyi        , Qxyi        , Uyi         , Uyi         , Uyi         , Uyi         , Uyi         , Uyi         , Aa          , Aa          , Aa          , Aa          , Xyui        
Xyui        , Xyui        , Xyui        , Xyui        , Xyui        , Xyui        , Uyi         , Qxyi        , Qxyi        , Qxyi        , Qxyi        , Qxyi        , Qxyi        , Qxyi        , Qxyi        , Qxyi        , Qxyi        , Qxyi        , Qxyi        , Qxyi        , Qxyi        , Uyi         , Uyi         , Uyi         , Uyi         , Uyi         , Uyi         , Aa          , Xyui        , Xyui        
Xyui        , Xyui        , Xyui        , Xyui        , Xyui        , Xyui        , Xyui        , Qxyi        , Qxyi        , Qxyi        , Qxyi        , Qxyi        , Qxyi        , Qxyi        , Qxyi        , Qxyi        , Qxyi        , Qxyi        , Qxyi        , Qxyi        , Qxyi        , Uyi         , Uyi         , Uyi         , Uyi         , Uyi         , Uyi         , Aa          , Xyui        , Xyui        
Xyui        , Xyui        , Xyui        , Xyui        , Xyui        , Xyui        , Xyui        , Qxyi        , Qxyi        , Qxyi        , Uyi         , Qxyi        , Qxyi        , Qxyi        , Qxyi        , Qxyi        , Qxyi        , Qxyi        , Qxyi        , Qxyi        , Uyi         , Uyi         , Xyui        , Uyi         , Xyui        , Uyi         , Aa          , Aa          , Aa          , Xyui        
Xyui        , Xyui        , Xyui        , Xyui        , Xyui        , Xyui        , Xyui        , Xyui        , Uyi         , Uyi         , Uyi         , Uyi         , Uyi         , Uyi         , Uyi         , Qxyi        , Qxyi        , Qxyi        , Uyi         , Uyi         , Xyui        , Xyui        , Xyui        , Xyui        , Xyui        , Xyui        , Xyui        , Xyui        , Xyui        , Xyui        
Xyui        , Xyui        , Xyui        , Xyui        , Xyui        , Aa          , Aa          , Uyi         , Aa          , Aa          , Aa          , Uyi         , Rb          , Tshy        , Uyi         , Uyi         , Uyi         , Uyi         , Xyui        , Xyui        , Xyui        , Xyui        , Xyui        , Xyui        , Xyui        , Xyui        , Xyui        , Xyui        , Xyui        , Xyui        
Xyui        , Xyui        , Xyui        , Xyui        , Aa          , Aa          , Uyi         , Aa          , Ai          , Ai          , Aa          , Aa          , Rb          , Rb          , Uyi         , Uyi         , Xyui        , Xyui        , Xyui        , Xyui        , Xyui        , Xyui        , Xyui        , Xyui        , Xyui        , Xyui        , Xyui        , Xyui        , Xyui        , Xyui        
Xyui        , Xyui        , Aa          , Aa          , Aa          , Uyi         , Uyi         , Aa          , Aa          , Ai          , Aa          , Aa          , Rb          , Rb          , Xyui        , Xyui        , Xyui        , Xyui        , Xyui        , Xyui        , Xyui        , Xyui        , Xyui        , Xyui        , Xyui        , Xyui        , Xyui        , Xyui        , Xyui        , Xyui        
Xyui        , Xyui        , Aa          , Aa          , Aa          , Uyi         , Xyui        , Xyui        , Xyui        , Xyui        , Xyui        , Uyi         , Rb          , Rb          , Uyi         , Xyui        , Ha          , Xyui        , Xyui        , Xyui        , Xyui        , Xyui        , Xyui        , Xyui        , Xyui        , Xyui        , Xyui        , Xyui        , Xyui        , Xyui        
Xyui        , Xyui        , Ai          , Ai          , Aa          , Xyui        , Xyui        , Xyui        , Xyui        , Xyui        , Xyui        , Uyi         , Rb          , Rb          , Uyi         , Uyi         , Ha          , Ha          , Uyi         , Xyui        , Xyui        , Xyui        , Xyui        , Xyui        , Xyui        , Xyui        , Xyui        , Xyui        , Xyui        , Xyui        
Xyui        , Xyui        , Ai          , Ai          , Aa          , Xyui        , Xyui        , Xyui        , Xyui        , Xyui        , Ha          , Ha          , Ha          , Rb          , Uyi         , Ha          , Uyi         , Uyi         , Uyi         , Uyi         , Xyui        , Xyui        , Xyui        , Xyui        , Xyui        , Xyui        , Xyui        , Xyui        , Xyui        , Xyui        
Xyui        , Xyui        , Ai          , Ai          , Aa          , Ha          , Ha          , Uyi         , Uyi         , Ha          , Uyi         , Ha          , Rb          , Rb          , Uyi         , Uyi         , Uyi         , Uyi         , Xyui        , Xyui        , Xyui        , Xyui        , Xyui        , Xyui        , Xyui        , Xyui        , Xyui        , Xyui        , Xyui        , Xyui        
Xyui        , Xyui        , Aa          , Ai          , Aa          , Aa          , Aa          , Uyi         , Ha          , Uyi         , Ha          , Uyi         , Rb          , Uyi         , Uyi         , Uyi         , Xyui        , Xyui        , Xyui        , Xyui        , Xyui        , Xyui        , Xyui        , Xyui        , Xyui        , Xyui        , Xyui        , Xyui        , Xyui        , Xyui        
Xyui        , Xyui        , Xyui        , Aa          , Xyui        , Aa          , Xyui        , Xyui        , Xyui        , Xyui        , Xyui        , Uyi         , Rb          , Uyi         , Ha          , Ha          , Xyui        , Xyui        , Xyui        , Xyui        , Xyui        , Xyui        , Ha          , Uyi         , Uyi         , Ha          , Ha          , Ha          , Xyui        , Xyui        
Xyui        , Xyui        , Xyui        , Xyui        , Xyui        , Xyui        , Xyui        , Xyui        , Xyui        , Xyui        , Xyui        , Aa          , Rb          , Xyui        , Xyui        , Ha          , Xyui        , Xyui        , Xyui        , Xyui        , Xyui        , Ha          , Ha          , Uyi         , Uyi         , Uyi         , Uyi         , Ha          , Xyui        , Xyui        
Xyui        , Xyui        , Xyui        , Xyui        , Xyui        , Xyui        , Qxyi        , Xyui        , Uyi         , Xyui        , Uyi         , Aa          , Uyi         , Rb          , Rb          , Aa          , Uyi         , Xyui        , Uyi         , Xyui        , Uyi         , Xyui        , Uyi         , Uyi         , Uyi         , Uyi         , Uyi         , Uyi         , Xyui        , Xyui        
Xyui        , Xyui        , Xyui        , Xyui        , Uyi         , Uyi         , Uyi         , Qxyi        , Qxyi        , Uyi         , Uyi         , Uyi         , Uyi         , Uyi         , Rb          , Uyi         , Uyi         , Uyi         , Uyi         , Uyi         , Uyi         , Uyi         , Uyi         , Uyi         , Uyi         , Uyi         , Aa          , Aa          , Aa          , Xyui        
Xyui        , Xyui        , Xyui        , Xyui        , Uyi         , Aa          , Aa          , Uyi         , Uyi         , Uyi         , Rb^Cov      , Rb^Cov      , Rb^Cov      , Rb          , Uyi         , Uyi         , Aa          , Aa          , Aa          , Uyi         , Uyi         , Uyi         , Uyi         , Uyi         , Uyi         , Uyi         , Aa          , Aa          , Aa          , Xyui        
Xyui        , Xyui        , Xyui        , Uyi         , Aa          , Aa          , Ha          , Aa          , Ha          , Uyi         , Rb^Cov      , 1 Rb^Kov    , Rb^Cov      , Rb          , Uyi         , Uyi         , Ha          , Aa          , Aa          , Aa          , Aa          , Uyi         , Uyi         , Uyi         , Aa          , Aa          , Aa          , Aa          , Ha          , Xyui        
Xyui        , Xyui        , Xyui        , Uyi         , Uyi         , Aa          , Ha          , Ha          , Ha          , Uyi         , Uyi         , Rb^Cov      , Uyi         , Uyi         , Ha          , Ha          , Ha          , Aa          , Aa          , Aa          , Aa          , Uyi         , Uyi         , Uyi         , Aa          , Aa          , Ha          , Ha          , Xyui        , Xyui        
Xyui        , Xyui        , Xyui        , Xyui        , Xyui        , Ha          , Ha          , Ha          , Uyi         , Uyi         , Uyi         , Uyi         , Uyi         , Ha          , Ha          , Ha          , Uyi         , Uyi         , Uyi         , Aa          , Uyi         , Uyi         , Uyi         , Uyi         , Ha          , Ha          , Xyui        , Xyui        , Xyui        , Xyui        
Xyui        , Xyui        , Xyui        , Xyui        , Xyui        , Xyui        , Xyui        , Uyi         , Xyui        , Xyui        , Xyui        , Xyui        , Xyui        , Uyi         , Uyi         , Uyi         , Xyui        , Uyi         , Uyi         , Uyi         , Uyi         , Uyi         , Ha          , Ha          , Ha          , Ha          , Xyui        , Xyui        , Xyui        , Xyui        
Xyui        , Xyui        , Xyui        , Xyui        , Xyui        , Xyui        , Xyui        , Xyui        , Xyui        , Xyui        , Xyui        , Xyui        , Xyui        , Xyui        , Xyui        , Xyui        , Xyui        , Xyui        , Xyui        , Xyui        , Xyui        , Xyui        , Xyui        , Xyui        , Xyui        , Xyui        , Xyui        , Xyui        , Xyui        , Xyui        
