border_size=1
usage=map

Xyui        , Xyui        , Xyui        , Xyui        , Xyui        , Xyui        , Xyui        , Xyui        , Xyui        , Xyui        , Xyui        , Xyui        , Xyui        , Xyui        , Xyui        , Xyui        , Xyui        , Xyui        , Xyui        , Xyui        , Xyui        , Xyui        , Xyui        , Xyui        , Xyui        , Xyui        , Xyui        , Xyui        , Uyi         , Uyi         
Xyui        , Xyui        , Xyui        , Xyui        , Xyui        , Xyui        , Xyui        , Xyui        , Xyui        , Xyui        , Xyui        , Xyui        , Xyui        , Xyui        , Xyui        , Xyui        , Xyui        , Xyui        , Xyui        , Xyui        , Xyui        , Xyui        , Xyui        , Xyui        , Xyui        , Xyui        , Uyi         , Uyi         , Uyi         , Uyi         
Xyui        , Xyui        , Xyui        , Xyui        , Uyi         , Xyui        , Xyui        , Xyui        , Xyui        , Xyui        , Xyui        , Xyui        , Xyui        , Xyui        , Xyui        , Xyui        , Xyui        , Xyui        , Xyui        , Xyui        , Xyui        , Xyui        , Xyui        , Xyui        , Xyui        , Xyui        , Uyi         , Uyi         , Xyui        , Xyui        
Xyui        , Xyui        , Xyui        , Xyui        , Xyui        , Uyi         , 2 Uyi       , Xyui        , Xyui        , Xyui        , Xyui        , Xyui        , Xyui        , Xyui        , Xyui        , Xyui        , Xyui        , Xyui        , Xyui        , Xyui        , Xyui        , Xyui        , Xyui        , Xyui        , Xyui        , Xyui        , Xyui        , Xyui        , Xyui        , Xyui        
Xyui        , Xyui        , Xyui        , Xyui        , Xyui        , Xyui        , Xyui        , Uyi         , Uyi         , Xyui        , Uyi         , Xyui        , Xyui        , Xyui        , Xyui        , Xyui        , Xyui        , Xyui        , Xyui        , Xyui        , Xyui        , Xyui        , Xyui        , Xyui        , Xyui        , Xyui        , Xyui        , Xyui        , Xyui        , Xyui        
Xyui        , Xyui        , Xyui        , Xyui        , Xyui        , Xyui        , Xyui        , Xyui        , Xyui        , Uyi         , Uyi         , Uyi         , Qxyi        , Xyui        , Qxyi        , Xyui        , Xyui        , Xyui        , Xyui        , Xyui        , Xyui        , Xyui        , Xyui        , Xyui        , Xyui        , Xyui        , Xyui        , Xyui        , Xyui        , Xyui        
Xyui        , Xyui        , Xyui        , Xyui        , Xyui        , Xyui        , Xyui        , Xyui        , Xyui        , Xyui        , Qxyi        , Qxyi        , Qxyi        , Qxyi        , Qxyi        , Qxyi        , Qxyi        , Xyui        , Xyui        , Xyui        , Xyui        , Xyui        , Xyui        , Xyui        , Xyui        , Xyui        , Xyui        , Xyui        , Xyui        , Xyui        
Xyui        , Xyui        , Xyui        , Xyui        , Xyui        , Xyui        , Xyui        , Xyui        , Qxyi        , Qxyi        , Qxyi        , Qxyi        , Qxyi        , Qxyi        , Qxyi        , Qxyi        , Qxyi        , Uyi         , Uyi         , Uyi         , Qxyi        , Uyi         , Xyui        , Xyui        , Uyi         , Xyui        , Aa          , Xyui        , Xyui        , Xyui        
Xyui        , Xyui        , Xyui        , Xyui        , Xyui        , Xyui        , Uyi         , Xyui        , Qxyi        , Qxyi        , Qxyi        , Qxyi        , Qxyi        , Qxyi        , Qxyi        , Qxyi        , Qxyi        , Qxyi        , Qxyi        , Uyi         , Uyi         , Qxyi        , Uyi         , Uyi         , Uyi         , Aa          , Aa          , Aa          , Aa          , Xyui        
Xyui        , Xyui        , Xyui        , Xyui        , Xyui        , Xyui        , Uyi         , Qxyi        , Qxyi        , Qxyi        , Qxyi        , Qxyi        , Qxyi        , Qxyi        , Qxyi        , Qxyi        , Qxyi        , Qxyi        , Qxyi        , Qxyi        , Qxyi        , Uyi         , Uyi         , Uyi         , Uyi         , Uyi         , Uyi         , Aa          , Xyui        , Xyui        
Xyui        , Xyui        , Xyui        , Xyui        , Xyui        , Xyui        , Xyui        , Qxyi        , Qxyi        , Qxyi        , Qxyi        , Qxyi        , Qxyi        , Qxyi        , Qxyi        , Qxyi        , Qxyi        , Qxyi        , Qxyi        , Qxyi        , Qxyi        , Uyi         , Uyi         , Uyi         , Uyi         , Uyi         , Uyi         , Aa          , Xyui        , Xyui        
Xyui        , Xyui        , Xyui        , Xyui        , Xyui        , Xyui        , Xyui        , Qxyi        , Qxyi        , Qxyi        , Uyi         , Qxyi        , Qxyi        , Qxyi        , Qxyi        , Qxyi        , Qxyi        , Qxyi        , Qxyi        , Qxyi        , Uyi         , Uyi         , Xyui        , Uyi         , Xyui        , Uyi         , Aa          , Aa          , Aa          , Xyui        
Xyui        , Xyui        , Xyui        , Xyui        , Xyui        , Xyui        , Xyui        , Xyui        , Uyi         , Uyi         , Uyi         , Uyi         , Uyi         , Uyi         , Uyi         , Qxyi        , Qxyi        , Qxyi        , Uyi         , Uyi         , Xyui        , Xyui        , Xyui        , Xyui        , Xyui        , Xyui        , Xyui        , Xyui        , Xyui        , Xyui        
Xyui        , Xyui        , Xyui        , Xyui        , Xyui        , Aa          , Aa          , Tshy        , Aa          , Aa          , Aa          , Uyi         , Rb          , Uyi         , Uyi         , Uyi         , Uyi         , Uyi         , Xyui        , Xyui        , Xyui        , Xyui        , Xyui        , Xyui        , Xyui        , Xyui        , Xyui        , Xyui        , Xyui        , Xyui        
Xyui        , Xyui        , Xyui        , Xyui        , Aa          , Aa          , Uyi         , Aa          , Ai          , Ai          , Aa          , Aa          , Rb          , Rb          , Uyi         , Uyi         , Xyui        , Xyui        , Xyui        , Xyui        , Xyui        , Xyui        , Xyui        , Xyui        , Xyui        , Xyui        , Xyui        , Xyui        , Xyui        , Xyui        
Xyui        , Xyui        , Aa          , Aa          , Aa          , Uyi         , Uyi         , Aa          , Aa          , Ai          , Aa          , Aa          , Rb          , Rb          , Xyui        , Xyui        , Xyui        , Xyui        , Xyui        , Xyui        , Xyui        , Xyui        , Xyui        , Xyui        , Xyui        , Xyui        , Xyui        , Xyui        , Xyui        , Xyui        
Xyui        , Xyui        , Aa          , Aa          , Aa          , Uyi         , Xyui        , Xyui        , Xyui        , Xyui        , Xyui        , Uyi         , Rb          , Rb          , Uyi         , Xyui        , Ha          , Xyui        , Xyui        , Xyui        , Xyui        , Xyui        , Xyui        , Xyui        , Xyui        , Xyui        , Xyui        , Xyui        , Xyui        , Xyui        
Xyui        , Xyui        , Ai          , Ai          , Aa          , Xyui        , Xyui        , Xyui        , Xyui        , Xyui        , Xyui        , Uyi         , Rb          , Rb          , Uyi         , Uyi         , Ha          , Ha          , Uyi         , Xyui        , Xyui        , Xyui        , Xyui        , Xyui        , Xyui        , Xyui        , Xyui        , Xyui        , Xyui        , Xyui        
Xyui        , Xyui        , Ai          , Ai          , Aa          , Xyui        , Xyui        , Xyui        , Xyui        , Xyui        , Ha          , Ha          , Ha          , Rb          , Uyi         , Ha          , Uyi         , Uyi         , Uyi         , Uyi         , Xyui        , Xyui        , Xyui        , Xyui        , Xyui        , Xyui        , Xyui        , Xyui        , Xyui        , Xyui        
Xyui        , Xyui        , Ai          , Ai          , Aa          , Ha          , Ha          , Uyi         , Uyi         , Ha          , Uyi         , Ha          , Rb          , Rb          , Uyi         , Uyi         , Uyi         , Uyi         , Xyui        , Xyui        , Xyui        , Xyui        , Xyui        , Xyui        , Xyui        , Xyui        , Xyui        , Xyui        , Xyui        , Xyui        
Xyui        , Xyui        , Aa          , Ai          , Aa          , Aa          , Aa          , Uyi         , Ha          , Uyi         , Ha          , Uyi         , Rb          , Uyi         , Uyi         , Uyi         , Xyui        , Xyui        , Xyui        , Xyui        , Xyui        , Xyui        , Xyui        , Xyui        , Xyui        , Xyui        , Xyui        , Xyui        , Xyui        , Xyui        
Xyui        , Xyui        , Xyui        , Aa          , Xyui        , Aa          , Xyui        , Xyui        , Xyui        , Xyui        , Xyui        , Uyi         , Rb          , Uyi         , Ha          , Ha          , Xyui        , Xyui        , Xyui        , Xyui        , Xyui        , Xyui        , Ha          , Uyi         , Uyi         , Ha          , Ha          , Ha          , Xyui        , Xyui        
Xyui        , Xyui        , Xyui        , Xyui        , Xyui        , Xyui        , Xyui        , Xyui        , Xyui        , Xyui        , Xyui        , Aa          , Rb          , Xyui        , Xyui        , Ha          , Xyui        , Xyui        , Xyui        , Xyui        , Xyui        , Ha          , Ha          , Uyi         , Uyi         , Uyi         , Uyi         , Ha          , Xyui        , Xyui        
Xyui        , Xyui        , Xyui        , Xyui        , Xyui        , Xyui        , Qxyi        , Xyui        , Uyi         , Xyui        , Uyi         , Aa          , Uyi         , Rb          , Rb          , Aa          , Uyi         , Xyui        , Uyi         , Xyui        , Uyi         , Xyui        , Uyi         , Uyi         , Uyi         , Uyi         , Uyi         , Uyi         , Xyui        , Xyui        
Xyui        , Xyui        , Xyui        , Xyui        , Uyi         , Uyi         , Uyi         , Qxyi        , Qxyi        , Uyi         , Uyi         , Uyi         , Uyi         , Uyi         , Rb          , Uyi         , Uyi         , Uyi         , Uyi         , Uyi         , Uyi         , Uyi         , Uyi         , Uyi         , Uyi         , Uyi         , Aa          , Aa          , Aa          , Xyui        
Xyui        , Xyui        , Xyui        , Xyui        , Uyi         , Aa          , Aa          , Uyi         , Uyi         , Uyi         , Rb^Cov      , Rb^Cov      , Rb^Cov      , Rb          , Uyi         , Uyi         , Aa          , Aa          , Aa          , Uyi         , Uyi         , Uyi         , Uyi         , Uyi         , Uyi         , Uyi         , Aa          , Aa          , Aa          , Xyui        
Xyui        , Xyui        , Xyui        , Uyi         , Aa          , Aa          , Ha          , Aa          , Ha          , Uyi         , Rb^Cov      , 1 Rb^Kov    , Rb^Cov      , Rb          , Uyi         , Uyi         , Ha          , Aa          , Aa          , Aa          , Aa          , Uyi         , Uyi         , Uyi         , Aa          , Aa          , Aa          , Aa          , Ha          , Xyui        
Xyui        , Xyui        , Xyui        , Uyi         , Uyi         , Aa          , Ha          , Ha          , Ha          , Uyi         , Uyi         , Rb^Cov      , Uyi         , Uyi         , Ha          , Ha          , Ha          , Aa          , Aa          , Aa          , Aa          , Uyi         , Uyi         , Uyi         , Aa          , Aa          , Ha          , Ha          , Xyui        , Xyui        
Xyui        , Xyui        , Xyui        , Xyui        , Xyui        , Ha          , Ha          , Ha          , Uyi         , Uyi         , Uyi         , Uyi         , Uyi         , Ha          , Ha          , Ha          , Uyi         , Uyi         , Uyi         , Aa          , Uyi         , Uyi         , Uyi         , Uyi         , Ha          , Ha          , Xyui        , Xyui        , Xyui        , Xyui        
Xyui        , Xyui        , Xyui        , Xyui        , Xyui        , Xyui        , Xyui        , Uyi         , Xyui        , Xyui        , Xyui        , Xyui        , Xyui        , Uyi         , Uyi         , Uyi         , Xyui        , Uyi         , Uyi         , Uyi         , Uyi         , Uyi         , Ha          , Ha          , Ha          , Ha          , Xyui        , Xyui        , Xyui        , Xyui        
Xyui        , Xyui        , Xyui        , Xyui        , Xyui        , Xyui        , Xyui        , Xyui        , Xyui        , Xyui        , Xyui        , Xyui        , Xyui        , Xyui        , Xyui        , Xyui        , Xyui        , Xyui        , Xyui        , Xyui        , Xyui        , Xyui        , Xyui        , Xyui        , Xyui        , Xyui        , Xyui        , Xyui        , Xyui        , Xyui        
