border_size=1
usage=map

Qxua        , Qxua        , Qxua        , Qxua        , Qxua        , Qxua        , Qxua        , Qxua        , Qxua        , Qxua        , Qxua        , Qxua        , Qxua        , Qxua        , Qxua        , Qxua        , Qxua        , Qxua        , Qxua        , Qxua        , Qxua        , Qxua        , Qxua        , Qxua        , Qxua        , Qxua        , Qxua        , Qxua        , Qxua        , Qxua        , Qxua        , Qxua        , Qxua        , Qxua        , Qxua        , Qxua        , Qxua        , Qxua        , Qxua        , Qxua        , Qxua        , Qxua        , Qxua        , Qxua        , Qxua        , Qxua        
Qxua        , Qxua        , Qxua        , Qxua        , Qxua        , Qxua        , Qxua        , Qxua        , Qxua        , Qxua        , Qxua        , Qxua        , Qxua        , Qxua        , Qxua        , Qxua        , Qxua        , Qxua        , Qxua        , Qxua        , Qxua        , Qxua        , Qxua        , Qxua        , Qxua        , Qxua        , Qxua        , Qxua        , Qxua        , Qxua        , Qxua        , Qxua        , Qxua        , Qxua        , Qxua        , Qxua        , Qxua        , Qxua        , Qxua        , Qxua        , Qxua        , Qxua        , Qxua        , Qxua        , Qxua        , Qxua        
Qxua        , Qxua        , Qxua        , Qxua        , Qxua        , Qxua        , Qxua        , Qxua        , Qxua        , Tmmy        , Qxua        , Qxua        , Qxua        , Qxua        , Qxua        , Qxua        , Qxua        , Qxua        , Qxua        , Qxua        , Qxua        , Qxua        , Qxua        , Qxua        , Qxua        , Qxua        , Qxua        , Qxua        , Qxua        , Qxua        , Qxua        , Qxua        , Qxua        , Qxua        , Qxua        , Re          , Re          , Re          , Re          , Re          , Re          , Qxua        , Re          , Qxua        , Qxua        , Qxua        
Qxua        , Qxua        , Qxua        , Qxua        , Qxua        , Qxua        , Qxua        , Qxua        , Qxua        , Qxua        , Qxua        , Qxua        , Qxua        , Qxua        , Qxua        , Qxua        , Qxua        , Qxua        , Qxua        , Qxua        , Qxua        , Qxua        , Qxua        , Qxua        , Qxua        , Qxua        , Qxua        , Qxua        , Qxua        , Qxua        , Qxua        , Qxua        , Qxua        , Qxua        , Re          , Re          , Re          , Re          , Re          , Re          , Md          , Re          , Re          , Qxua        , Qxua        , Qxua        
Qxua        , Qxua        , Qxua        , Qxua        , Qxua        , Qxua        , Qxua        , Qxua        , Qxua        , Qxua        , Qxua        , Qxua        , Qxua        , Qxua        , Qxua        , Qxua        , Qxua        , Qxua        , Qxua        , Qxua        , Qxua        , Qxua        , Qxua        , Qxua        , Qxua        , Qxua        , Qxua        , Qxua        , Re          , Re          , Qxua        , Qxua        , Qxua        , Qxua        , Re          , Re          , Re          , Re^Vct      , Re          , Re          , Re          , Re          , Re          , Qxua        , Qxua        , Qxua        
Qxua        , Qxua        , Qxua        , Qxua        , Qxua        , Qxua        , Qxua        , Qxua        , Qxua        , Qxua        , Qxua        , Qxua        , Qxua        , Qxua        , Qxua        , Qxua        , Re          , Re          , Qxua        , Qxua        , Qxua        , Qxua        , Qxua        , Qxua        , Qxua        , Re          , Ce          , Re          , Md          , Md          , Re          , Qxua        , Qxua        , Qxua        , Qxua        , Re          , Re          , Re          , Re          , Re          , Re^Fetd     , Re          , Re          , Qxua        , Qxua        , Qxua        
Qxua        , Qxua        , Qxua        , Qxua        , Qxua        , Qxua        , Re          , Re          , Re          , Re          , Re          , Qxua        , Re          , Qxua        , Re          , Re          , Re          , Re          , Re          , Qxua        , Qxua        , Qxua        , Qxua        , Qxua        , Qxua        , Re          , Re          , Ket         , Ce          , Re          , Re          , Re          , Re          , Qxua        , Qxua        , Qxua        , Re          , Re          , Re          , Re          , Re          , Re          , Re          , Qxua        , Qxua        , Qxua        
Qxua        , Qxua        , Qxua        , Qxua        , Re          , Re          , Re          , Re          , Re          , Re          , Re^Lyd|     , Re          , Re          , Re          , Re          , Re          , Re          , Re          , Re          , Qxua        , Qxua        , Qxua        , Qxua        , Qxua        , Qxua        , Re          , Re          , Ce          , Re          , Re          , Re          , Re          , Re          , Qxua        , Qxua        , Qxua        , Qxua        , Re          , Qxua        , Re          , Re          , Re          , Qxua        , Qxua        , Qxua        , Qxua        
Qxua        , Qxua        , Qxua        , Qxua        , Rd          , Re          , Re          , Re          , Re          , Re          , Re          , Re          , Re          , Re          , Rd          , Re          , Re          , Re          , Qxua        , Qxua        , Qxua        , Qxua        , Qxua        , Qxua        , Re^Fetd     , Re          , Re          , Re          , Qxua        , Qxua        , Qxua        , Qxua        , Qxua        , Qxua        , Qxua        , Qxua        , Qxua        , Qxua        , Qxua        , Qxua        , Qxua        , Qxua        , Qxua        , Qxua        , Qxua        , Qxua        
Qxua        , Qxua        , Re          , Re          , Re          , Re          , Re          , Cay         , Re          , Re          , Re          , Re          , Re          , Re          , Rd          , Rd          , Qxua        , Qxua        , Qxua        , Qxua        , Qxua        , Qxua        , Qxua        , Qxua        , Qxua        , Re          , Qxua        , Qxua        , Qxua        , Qxua        , Qxua        , Qxua        , Qxua        , Qxua        , Qxua        , Qxua        , Qxua        , Qxua        , Qxua        , Qxua        , Qxua        , Qxua        , Qxua        , Qxua        , Qxua        , Qxua        
Qxua        , Qxua        , Qxua        , Re          , Qxua        , Re          , Re          , Re          , Rd          , Re          , Re          , Re          , Re^Dr       , Re          , Rd          , Qxua        , Qxua        , Qxua        , Qxua        , Qxua        , Qxua        , Qxua        , Qxua        , Qxua        , Qxua        , Qxua        , Qxua        , Qxua        , Qxua        , Qxua        , Qxua        , Qxua        , Qxua        , Qxua        , Qxua        , Qxua        , Re          , Qxua        , Re          , Qxua        , Qxua        , Qxua        , Qxua        , Qxua        , Qxua        , Qxua        
Qxua        , Qxua        , Qxua        , Qxua        , Qxua        , Qxua        , Qxua        , Qxua        , Qxua        , Qxua        , Qxua        , Re          , Rd          , Re          , Qxua        , Qxua        , Qxua        , Qxua        , Qxua        , Qxua        , Qxua        , Qxua        , Qxua        , Qxua        , Qxua        , Qxua        , Qxua        , Qxua        , Qxua        , Qxua        , Qxua        , Qxua        , Re          , Qxua        , Re          , Re          , Dd          , Re          , Dd          , Re          , Re          , Qxua        , Qxua        , Qxua        , Qxua        , Qxua        
Qxua        , Qxua        , Qxua        , Qxua        , Qxua        , Qxua        , Qxua        , Qxua        , Qxua        , Qxua        , Qxua        , Qxua        , Qxua        , Qxua        , Qxua        , Qxua        , Qxua        , Qxua        , Qxua        , Qxua        , Qxua        , Qxua        , Qxua        , Qxua        , Qxua        , Qxua        , Qxua        , Qxua        , Re          , Re          , Re          , Re          , Re          , Re          , Dd          , Dd          , Cdr         , Dd          , Dd          , Dd          , Dd          , Qxua        , Qxua        , Qxua        , Qxua        , Qxua        
Qxua        , Qxua        , Qxua        , Qxua        , Qxua        , Qxua        , Re          , Qxua        , Qxua        , Qxua        , Qxua        , Qxua        , Qxua        , Qxua        , Qxua        , Qxua        , Qxua        , Qxua        , Qxua        , Qxua        , Qxua        , Qxua        , Qxua        , Qxua        , Qxua        , Qxua        , Re          , Re          , Re          , Re          , Re          , Re          , Dd^Vda      , Dd          , Dd          , Cdr         , Dd          , Kdr         , Cdr         , Cdr         , Dd          , Dd          , Qxua        , Qxua        , Qxua        , Qxua        
Qxua        , Qxua        , Qxua        , Qxua        , Re          , Re          , Hhd         , Re          , Re          , Rd          , Re          , Rd          , Re          , Qxua        , Qxua        , Qxua        , Qxua        , Qxua        , Qxua        , Qxua        , Re          , Re          , Re          , Re          , Re          , Re          , Re          , Re          , Re          , Hhd         , Re          , Re          , Re          , Dd^Do       , Re          , Dd          , Re          , Dd          , Dd          , Dd          , Dd          , Qxua        , Qxua        , Qxua        , Qxua        , Qxua        
Qxua        , Qxua        , Qxua        , Re          , Hhd         , Hhd         , Re          , Hhd         , Re          , Re          , Re          , Re          , Re          , Rd          , Qxua        , Qxua        , Qxua        , Qxua        , Qxua        , Qxua        , Qxua        , Re          , Qxua        , Rd          , Rd          , Re          , Re          , Re          , Re          , Re          , Re          , Re          , Re          , Re          , Re          , Re          , Re          , Re          , Qxua        , Dd          , Qxua        , Qxua        , Qxua        , Qxua        , Qxua        , Qxua        
Qxua        , Qxua        , Qxua        , Re          , Re          , Re          , Re          , Re          , Re          , Re          , Re          , Re          , Re          , Re^Dr       , Qxua        , Qxua        , Qxua        , Qxua        , Qxua        , Qxua        , Qxua        , Qxua        , Qxua        , Qxua        , Qxua        , Qxua        , Qxua        , Qxua        , Qxua        , Qxua        , Qxua        , Qxua        , Qxua        , Re          , Qxua        , Qxua        , Qxua        , Qxua        , Qxua        , Qxua        , Qxua        , Qxua        , Qxua        , Qxua        , Qxua        , Qxua        
Qxua        , Qxua        , Qxua        , Qxua        , Rd          , Re          , Re          , Re^Vc       , Re          , Re          , Re          , Re          , Qxua        , Qxua        , Qxua        , Qxua        , Qxua        , Qxua        , Qxua        , Qxua        , Qxua        , Qxua        , Qxua        , Qxua        , Qxua        , Qxua        , Qxua        , Qxua        , Rd          , Qxua        , Qxua        , Qxua        , Qxua        , Qxua        , Qxua        , Qxua        , Qxua        , Qxua        , Qxua        , Qxua        , Qxua        , Qxua        , Qxua        , Qxua        , Qxua        , Qxua        
Qxua        , Qxua        , Qxua        , Qxua        , Qxua        , Re          , Rd          , Re          , Re          , Re          , Qxua        , Qxua        , Qxua        , Qxua        , Qxua        , Qxua        , Qxua        , Qxua        , Qxua        , Qxua        , Qxua        , Qxua        , Qxua        , Qxua        , Qxua        , Qxua        , Re          , Re          , Re          , Re          , Re          , Qxua        , Qxua        , Qxua        , Qxua        , Qxua        , Qxua        , Qxua        , Re          , Qxua        , Re          , Qxua        , Qxua        , Qxua        , Qxua        , Qxua        
Qxua        , Qxua        , Qxua        , Qxua        , Qxua        , Qxua        , Qxua        , Qxua        , Qxua        , Qxua        , Qxua        , Qxua        , Qxua        , Qxua        , Dd          , Dd          , Dd          , Qxua        , Rd          , Qxua        , Qxua        , Qxua        , Qxua        , Qxua        , Qxua        , Qxua        , Rd          , Re          , Re          , Re          , Rr^Vd       , Re          , Re          , Re          , Re          , Qxua        , Qxua        , Re          , Re          , Re^Vc       , Re          , Qxua        , Qxua        , Qxua        , Qxua        , Qxua        
Qxua        , Qxua        , Qxua        , Qxua        , Qxua        , Qxua        , Qxua        , Qxua        , Qxua        , Qxua        , Qxua        , Qxua        , Qxua        , Dd          , Dd          , Dd          , Dd          , Rd          , Rd          , Re          , Re          , Re          , Re          , Qxua        , Qxua        , Qxua        , Qxua        , Rd          , Re          , Rr          , Re          , Rr          , Hhd         , Re          , Re          , Qxua        , Qxua        , Qxua        , Qxua        , Re          , Qxua        , Qxua        , Qxua        , Qxua        , Qxua        , Qxua        
Qxua        , Qxua        , Qxua        , Qxua        , Rd          , Qxua        , Rd          , Qxua        , Qxua        , Qxua        , Qxua        , Qxua        , Qxua        , Rd          , Dd          , Dd          , Rd          , Rd          , Hhd         , Re          , Hhd         , Re          , Re          , Re          , Re          , Qxua        , Qxua        , Qxua        , Qxua        , Re          , Re          , Md          , Re          , Re          , Qxua        , Re          , Qxua        , Qxua        , Qxua        , Qxua        , Qxua        , Qxua        , Qxua        , Qxua        , Qxua        , Qxua        
Qxua        , Qxua        , Re          , Rd          , Re          , Re          , Re          , Re          , Re          , Qxua        , Qxua        , Qxua        , Qxua        , Rd          , Rd          , Dd          , Rd          , Rd          , Hhd         , Md          , Md          , Ch          , Md          , Re          , Re          , Rd          , Rd          , Qxua        , Qxua        , Qxua        , Qxua        , Re          , Qxua        , Qxua        , Qxua        , Qxua        , Qxua        , Qxua        , Qxua        , Qxua        , Qxua        , Qxua        , Qxua        , Qxua        , Qxua        , Qxua        
Qxua        , Qxua        , Qxua        , Re          , Hhd         , Md          , Re          , Re          , Re          , Qxua        , Qxua        , Qxua        , Qxua        , Qxua        , Rd          , Rd          , Re          , Re          , Hhd         , Hhd         , Md          , Kh          , Md          , Md          , Re          , Re          , Re          , Re          , Qxua        , Qxua        , Qxua        , Qxua        , Qxua        , Qxua        , Re          , Qxua        , Re          , Qxua        , Re          , Qxua        , Qxua        , Qxua        , Qxua        , Qxua        , Qxua        , Qxua        
Qxua        , Qxua        , Qxua        , Re          , Re          , Re          , Re^Vc       , Re          , Re          , Re^Fetd     , Qxua        , Qxua        , Qxua        , Qxua        , Qxua        , Re          , Qxua        , Re          , Re          , Re          , Re          , Ch          , Re          , Re          , Re          , Re          , Rd          , Re          , Qxua        , Qxua        , Qxua        , Qxua        , Qxua        , Qxua        , Re          , Re          , Md          , Re          , Re          , Re          , Re          , Qxua        , Qxua        , Qxua        , Qxua        , Qxua        
Qxua        , Qxua        , Qxua        , Rd          , Re          , Re          , Re          , Re          , Qxua        , Qxua        , Qxua        , Qxua        , Qxua        , Qxua        , Qxua        , Qxua        , Qxua        , Qxua        , Qxua        , Re          , Re          , Re          , Re          , Re          , Qxua        , Qxua        , Qxua        , Qxua        , Qxua        , Qxua        , Qxua        , Qxua        , Qxua        , Qxua        , Re          , Hhd         , Re          , Re          , Re          , Re^Dr       , Re          , Re          , Qxua        , Qxua        , Qxua        , Qxua        
Qxua        , Qxua        , Qxua        , Qxua        , Qxua        , Rd          , Qxua        , Qxua        , Qxua        , Qxua        , Qxua        , Qxua        , Rd          , Rd          , Dd          , Qxua        , Qxua        , Qxua        , Qxua        , Qxua        , Qxua        , Qxua        , Qxua        , Qxua        , Qxua        , Qxua        , Qxua        , Qxua        , Qxua        , Qxua        , Qxua        , Qxua        , Qxua        , Qxua        , Qxua        , Re          , Qxua        , Re          , Qxua        , Re          , Re          , Qxua        , Qxua        , Qxua        , Qxua        , Qxua        
Qxua        , Qxua        , Qxua        , Qxua        , Qxua        , Qxua        , Qxua        , Qxua        , Re          , Qxua        , Re          , Rd          , Dd          , Dd          , Dd          , Dd          , Qxua        , Qxua        , Qxua        , Qxua        , Qxua        , Qxua        , Qxua        , Qxua        , Qxua        , Qxua        , Qxua        , Qxua        , Qxua        , Qxua        , Qxua        , Qxua        , Qxua        , Qxua        , Qxua        , Qxua        , Qxua        , Qxua        , Qxua        , Qxua        , Qxua        , Qxua        , Qxua        , Qxua        , Qxua        , Qxua        
Qxua        , Qxua        , Qxua        , Qxua        , Qxua        , Qxua        , Qxua        , Qxua        , Re          , Re          , Mm          , Rd          , Rd          , Dd          , Rd          , Dd          , Rd          , Qxua        , Qxua        , Qxua        , Qxua        , Qxua        , Qxua        , Qxua        , Qxua        , Qxua        , Qxua        , Qxua        , Qxua        , Qxua        , Qxua        , Qxua        , Qxua        , Qxua        , Qxua        , Qxua        , Rb          , Qxua        , Qxua        , Qxua        , Qxua        , Qxua        , Qxua        , Qxua        , Qxua        , Qxua        
Qxua        , Qxua        , Qxua        , Qxua        , Qxua        , Qxua        , Re          , Re          , Hhd         , Hhd         , Kpy         , Cpy         , Cpy         , Rd          , Re          , Rd          , Re          , Re          , Re          , Qxua        , Qxua        , Qxua        , Qxua        , Qxua        , Qxua        , Qxua        , Qxua        , Qxua        , Qxua        , Qxua        , Re          , Re          , Re          , Re          , Rb          , Rb          , Ctys        , Rb          , Re          , Re          , Re          , Qxua        , Qxua        , Qxua        , Qxua        , Qxua        
Qxua        , Qxua        , Qxua        , Qxua        , Qxua        , Re          , Re          , Re          , Re          , Mm          , Mm          , Cpy         , Re          , Re          , Re          , Mm          , Re          , Re          , Re          , Re          , Re          , Re          , Qxua        , Qxua        , Qxua        , Qxua        , Qxua        , Qxua        , Qxua        , Qxua        , Re          , Re          , Rb          , Ss^Vhs      , Ss          , Ss          , Ktys        , Ctys        , Ss          , Md          , Hhd         , Re          , Re          , Re          , Qxua        , Qxua        
Qxua        , Qxua        , Qxua        , Qxua        , Qxua        , Qxua        , Qxua        , Re          , Rd          , Re          , Rd          , Re          , Re          , Re          , Re          , Re          , Re          , Re          , Re          , Re          , Qxua        , Qxua        , Qxua        , Qxua        , Qxua        , Qxua        , Qxua        , Qxua        , Qxua        , Qxua        , Qxua        , Re          , Re          , Re          , Re          , Ss          , Ctys        , Ss          , Re          , Hhd         , Re          , Re          , Re          , Re          , Qxua        , Qxua        
Qxua        , Qxua        , Qxua        , Qxua        , Qxua        , Qxua        , Qxua        , Qxua        , Qxua        , Qxua        , Qxua        , Qxua        , Qxua        , Qxua        , Qxua        , Re          , Qxua        , Re          , Qxua        , Qxua        , Qxua        , Qxua        , Qxua        , Qxua        , Qxua        , Qxua        , Qxua        , Qxua        , Qxua        , Qxua        , Qxua        , Qxua        , Qxua        , Re          , Qxua        , Rb          , Rb          , Rb          , Re          , Re          , Re          , Re          , Qxua        , Re          , Qxua        , Qxua        
Qxua        , Qxua        , Qxua        , Qxua        , Qxua        , Qxua        , Qxua        , Qxua        , Qxua        , Qxua        , Qxua        , Qxua        , Qxua        , Qxua        , Qxua        , Qxua        , Qxua        , Qxua        , Qxua        , Qxua        , Qxua        , Qxua        , Qxua        , Qxua        , Qxua        , Qxua        , Qxua        , Qxua        , Qxua        , Qxua        , Qxua        , Qxua        , Qxua        , Qxua        , Qxua        , Qxua        , Qxua        , Qxua        , Qxua        , Qxua        , Qxua        , Qxua        , Qxua        , Qxua        , Qxua        , Qxua        
Qxua        , Qxua        , Qxua        , Qxua        , Qxua        , Qxua        , Qxua        , Qxua        , Qxua        , Qxua        , Qxua        , Qxua        , Qxua        , Qxua        , Qxua        , Qxua        , Qxua        , Qxua        , Qxua        , Qxua        , Qxua        , Qxua        , Qxua        , Qxua        , Qxua        , Qxua        , Qxua        , Qxua        , Qxua        , Qxua        , Qxua        , Qxua        , Qxua        , Qxua        , Qxua        , Qxua        , Qxua        , Qxua        , Qxua        , Qxua        , Qxua        , Qxua        , Qxua        , Qxua        , Qxua        , Qxua        
