border_size=1
usage=map

Md          , Md          , Hd          , Hd          , Hd          , Hd          , Hd          , Hd          , Md          , Md          , Md          , Md          , Md          , Md          , Md          , Md          , Md          , Hd          , Hd          , Hd          , Hd          , Hd          , Hd          , Hd          , Hd          , Md          , Md          , Md          , Md          , Md          
Md          , Md          , Hd          , Hd          , Dd          , Hd          , Hd          , Hd          , Hd          , Md          , Hd          , Md          , Md          , Md          , Hd          , Md          , Hd          , Hd          , Hd          , Hd          , Dd          , Hd          , Hd          , Hd          , Hd          , Md          , Md          , Md          , Md          , Md          
Hd          , Hd          , Hd          , Dd          , Rd          , Dd          , Hd          , Hd          , Hd          , Hd          , Hd          , Hd          , Hd          , Hd          , Hd          , Hd          , Hd          , Hd          , Rd          , Dd          , Dd          , Dd          , Hd          , Hd          , Hd          , Hd          , Hd          , Hd          , Md          , Md          
Hd          , Hd          , Hd          , Rd          , Rd          , Dd          , Dd          , Dd          , Dd          , Dd          , Dd          , Hd          , Hd          , Hd          , Dd          , Hd          , Gd          , Gd          , Rd          , Rd          , Dd          , Dd          , Dd          , Dd          , Dd          , Hd          , Hd          , Hd          , Hd          , Md          
Hd          , Hd          , Dd          , Dd          , Dd          , Hd          , Dd          , Dd          , Cay         , Cay         , Cay         , Rd          , Hd          , Dd          , Dd          , Dd          , Gd          , 2 Gd        , Gd          , Gd          , Hd          , Hd          , Dd          , Gd          , Gd          , Hd          , Hd          , Hd          , Hd          , Hd          
Hd          , Hd          , Dd          , Dd          , Dd          , Hd          , Dd          , Dd          , Cay         , 3 Kay       , Cay         , Rd          , Gd          , Rd          , Rd          , Dd          , Gd          , Gd          , Rd          , Hd          , Dd          , Hd          , Hd          , Gd          , Hd          , Hd          , Hd          , Hd          , Md          , Hd          
Hd          , Hd          , Hd          , Dd          , Dd          , Dd          , Dd          , Dd          , Rd          , Cay         , Rd          , Rd          , Gd          , Hd          , Hd          , Hd          , Gd          , Gd          , Gd          , Rd          , Dd          , Dd          , Hd          , Hd          , Hd          , Hd          , Hd          , Md          , Md          , Md          
Hd          , Hd          , Gd          , 4 Gd        , Dd          , Dd          , Dd          , Dd          , Gd          , Rd          , Hd          , Gd          , Gd          , Hd          , Hd          , Hd          , Gd          , Gd          , Gd          , Rd          , Dd          , Dd          , Hd          , Hd          , Hd          , Hd          , Md          , Md          , Md          , Md          
Hd          , Hd          , Gd          , Gd          , Gd          , Gd^Vhr      , Gd          , Gd          , Hd          , Hd          , Hd          , Gd          , Gd^Vhr      , Gd          , Hd          , Hd          , Hd          , Gd          , Dd          , Gd          , Dd          , Hd          , Hd          , Hd          , Hd          , Md          , Md          , Md          , Md          , Md          
Hd          , Hd          , Gd          , Gd          , Gd          , Gd          , Gd          , Gd          , Hd          , Hd          , Hd          , Gd          , Gd          , Gd          , Hd          , Hd          , Hd          , Dd          , Dd          , Dd          , Dd          , Dd          , Hd          , Hd          , Hd          , Md          , Md          , Md          , Md          , Md          
Hd          , Gd          , Gd          , Gd          , Hd          , Gd          , Gd          , Gd          , Dd          , Dd          , Dd          , Hd          , Hd          , Hd          , Hd          , Hd          , Hd          , Dd          , Dd          , Dd          , Dd          , Dd          , Hd          , Hd          , Hd          , Hd          , Hd          , Hd          , Hd          , Hd          
Hd          , Gd          , Gd          , Gd          , Hd          , Hd          , Gd          , Hd          , Gd          , Dd          , Dd          , Hd          , Gd          , Gd          , Hd          , Hd          , Rd          , Rd          , Gd          , Gd          , Dd          , Hd          , Hd          , Hd          , Hd          , Hd          , Hd          , Hd          , Hd          , Hd          
Hd          , Hd          , Gd          , Hd          , Hd          , Gd          , Dd          , Gd          , Gd          , Gd          , Gd          , Gd          , Dd          , Gd          , Dd          , Rd          , Dd          , Dd          , Dd          , Dd          , Dd          , Dd          , Dd          , Gd          , Dd          , Gd          , Hd          , Hd          , Hd          , Hd          
Hd          , Hd          , Gd          , Gd          , Gd          , Gd          , Dd          , Dd          , Dd          , Gd          , Dd          , Dd          , Dd          , Dd          , Dd          , Dd          , Dd          , Dd          , Dd          , Dd          , Dd^Fdw      , Dd          , Dd          , Dd          , Dd          , Dd          , Gd          , Hd          , Hd          , Hd          
Hd          , Gd          , Dd          , Dd          , Dd          , Dd          , Dd^Fdw      , Gd          , Gd          , Dd          , Dd          , Dd          , Dd          , Dd          , Gd          , Gd          , Gd          , Dd          , Gd          , Gs^Fdw      , Gs^Fdw      , Dd^Fdw      , Dd          , Dd          , Dd          , Dd          , Dd          , Gd          , Hd          , Hd          
Hd          , Dd          , Dd          , Dd          , Dd          , Dd^Fdw      , Dd^Fdw      , Gd          , Dd          , Dd          , Dd          , Dd          , Gd          , Gd          , Gd          , Gd          , Gd          , Gd          , Gd          , Gd          , Dd          , Dd          , Dd          , Hd          , Hd          , Dd          , Dd          , Gd          , Hd          , Hd          
Hd          , Dd          , Dd          , Dd          , Dd          , Dd          , Dd          , Dd^Fdw      , Dd          , Dd          , Dd          , Dd          , Rd          , Gd          , Gd          , Gd          , Gd          , Gd          , Gd          , Gd          , Gd          , Dd          , Dd          , Dd          , Hd          , Hd          , Hd          , Gd          , Hd          , Hd          
Hd          , Dd          , Hd          , Hd          , Gd          , Dd          , Dd          , Dd          , Dd          , Dd          , Dd          , Dd          , Uue         , Rd          , Rd          , Dd          , Dd          , Gd          , Gd          , Gd          , Gd          , Dd          , Dd          , Dd          , Dd          , Hd          , Hd          , Hd          , Hd          , Hd          
Hd          , Hd          , Hd          , Gd          , Gd          , Gd          , Dd          , Dd          , Dd          , Dd          , Dd          , Uue         , Uue         , Uue         , Rd          , Dd          , Dd          , Dd          , Gd          , Gd          , Gd          , Dd          , Dd          , Dd          , Dd          , Dd          , Hd          , Hd          , Hd          , Hd          
Hd          , Hd          , Gd          , Gd          , Gd          , Gd          , Dd          , Dd          , Dd          , Rd          , Rd          , Uue         , Uue         , Uue         , Dd          , Dd          , Gd          , Dd          , Gd          , Gd          , Gd          , Dd          , Dd          , Dd          , Gd          , Dd          , Dd          , Hd          , Hd          , Hd          
Hd          , Hd          , Gd          , Gd          , Gd          , Dd          , Dd          , Dd          , Dd          , Dd          , Dd          , Rd          , Rd          , Rd          , Dd          , Gd          , Gd          , Gd          , Gd          , Gd          , Dd          , Dd^Fdw      , Dd^Fdw      , Gd          , Gd          , Dd          , Dd          , Gd          , Hd          , Hd          
Hd          , Gd          , Gd          , Gd          , Dd          , Dd          , Gd          , Dd          , Dd          , Dd          , Gd          , Gd          , Gd          , Rd          , Gd          , Gd          , Gd          , Gd          , Gd          , Dd          , Dd          , Dd^Fdw      , Dd^Fdw      , Gs^Fdw      , Gd          , Gd          , Dd          , Dd          , Hd          , Hd          
Hd          , Gd          , Gd          , Gd          , Dd          , Rd          , Gd          , Gd          , Dd          , Dd          , Gd          , Gd          , Gd          , Gd          , Gd          , Gd          , Gd          , Gd          , Gd          , Dd          , Gd          , Dd          , Gs^Fdw      , Dd          , Dd          , Dd          , Dd          , Dd          , Hd          , Hd          
Hd          , Gd          , Gd          , Gd          , Gd          , Rd          , Rd          , Gd          , Dd          , Dd          , Dd^Fdw      , Dd^Fdw      , Gs^Fdw      , Gd          , Gd          , Gd          , Gd          , Gd          , Gd          , Gd          , Gd          , Gd          , Dd          , Dd          , Rd          , Dd          , Dd          , Dd          , Dd          , Hd          
Hd          , Gd          , Gd          , Gd          , Gd          , Dd          , Dd          , Dd          , Dd          , Gd          , Gd          , Gs^Fdw      , Gd          , Gd          , Gd          , Gd          , Gd          , Gd          , Gd          , Gd          , Gd          , Gd          , Dd          , Rd          , Rd          , Rd          , Dd          , Dd          , Hd          , Hd          
Hd          , Gd          , Gd          , Gd          , Dd          , Dd          , Dd          , Dd          , Gd          , Gd          , Gd          , Gd          , Gd          , Gd          , Rd          , Gd          , Gd          , Gd          , Gd^Vhr      , Gd          , Gd          , Gd          , Gd          , Dd          , Dd          , Dd          , Dd          , Dd          , Dd          , Hd          
Hd          , Gd          , Gd          , Gd          , Dd          , Dd          , Dd          , Gd          , Gd          , Gd^Vhr      , Gd          , Gd          , Rd          , Rd          , Cay         , Rd          , Rd          , Gd          , Gd          , Gd          , Gd          , Gd          , Gd          , Gd          , Gd          , Dd          , Dd          , Dd          , Dd          , Hd          
Hd          , Gd          , Gd          , Gd          , Dd          , Dd          , Dd          , Gd          , Gd          , Gd          , Gd          , Gd          , Rd          , Cay         , Kay         , Cay         , Rd          , Gd          , Gd          , Gd          , Gd          , Gd          , Gd          , Gd          , Gd          , Gd          , Gd          , Dd          , Dd          , Hd          
Hd          , Hd          , Gd          , Gd          , Gd          , Dd          , Dd          , Gd          , Gd          , Gd          , Gd          , Gd          , Rd          , Cay         , Cay         , Cay         , Rd          , Gd          , Gd          , Dd          , Dd          , Gd          , Gd          , Gd          , Gd          , Gd          , Rd          , Rd          , Dd          , Hd          
Hd          , Gd          , Gd          , Gd          , Gd          , Dd          , Dd          , Gd          , Gd          , Gd          , Gd          , Gd          , Gd          , Rd          , Rd          , Rd          , Gd          , Gd          , Gd          , Dd          , Dd          , Gd          , Gd          , Gd          , Gd          , Gd          , Gd          , Rd          , Dd          , Hd          
Hd          , Gd          , Gd          , Gd          , Dd          , Dd          , Dd          , Gd          , Gd          , Gd          , Gd          , Gd          , Gd          , Gd          , Gd          , Gd          , Gd          , Gd          , Gd          , Dd          , Dd          , Gd          , Gd          , Gd          , Gd          , Gd          , Gd          , Gd          , Dd          , Hd          
Xu          , Hd          , Dd          , Dd          , Dd          , Dd          , Dd          , Dd          , Dd          , Gd          , Gd          , Gd          , Gd          , Gd          , Gd          , Gd          , Gd          , Gd          , Gd          , Gd          , Gd          , Gd          , Gd          , Gd          , Gd          , Gd          , Dd          , Dd          , Hd          , Hd          
Xu          , Xu          , Xu          , Xu          , Xu          , Xu          , Xu          , Xu          , Xu          , Xu          , Xu          , Xu          , Xu          , Gd          , Xu          , Xu          , Xu          , Gd          , Xu          , Gd          , Xu          , Gd          , Gd          , Gd          , Gd          , Gd          , Dd          , Dd          , Xu          , Xu          
Xu          , Xu          , Xu          , Xu          , Xu          , Xu          , Xu          , Xu          , Xu          , Xu          , Xu          , Xu          , Xu          , Xu          , Xu          , Xu          , Xu          , Xu          , Xu          , Xu          , Xu          , Xu          , Xu          , Xu          , Xu          , Xu          , Xu          , Xu          , Xu          , Xu          
Xu          , Xu          , Xyui        , Xu          , Xyui        , Xyui        , Xyui        , Xu          , Xyui        , Xu          , Xyui        , Xu          , Xyui        , Xu          , Xyui        , Xyui        , Xyui        , Xu          , Xyui        , Xu          , Xu          , Xu          , Xu          , Xu          , Xu          , Xu          , Xu          , Xu          , Xu          , Xu          
Xyui        , Xyui        , Xyui        , Xyui        , Xyui        , Xyui        , Xyui        , Xyui        , Xyui        , Xyui        , Xyui        , Xyui        , Qxyi        , Xyui        , Qxyi        , Xyui        , Xyui        , Xyui        , Xyui        , Xyui        , Xyui        , Xyui        , Xyui        , Xyui        , Xyui        , Xyui        , Xyui        , Xyui        , Xyui        , Xu          
Xyui        , Xyui        , Xyui        , Xyui        , Xyui        , Xyui        , Xyui        , Xyui        , Xyui        , Xyui        , Qxyi        , Qxyi        , Qxyi        , Qxyi        , Qxyi        , Qxyi        , Qxyi        , Xyui        , Xyui        , Xyui        , Xyui        , Xyui        , Xyui        , Xyui        , Xyui        , Xyui        , Xyui        , Xyui        , Xyui        , Xyui        
Xyui        , Xyui        , Xyui        , Xyui        , Xyui        , Xyui        , Xyui        , Xyui        , Qxyi        , Qxyi        , Qxyi        , Qxyi        , Qxyi        , Qxyi        , Qxyi        , Qxyi        , Qxyi        , Uyi         , Uyi         , Uyi         , Uyi         , Uyi         , Xyui        , Xyui        , Uyi         , Xyui        , Aa          , Xyui        , Xyui        , Xyui        
Xyui        , Xyui        , Xyui        , Xyui        , Xyui        , Xyui        , Uyi         , Xyui        , Qxyi        , Qxyi        , Qxyi        , Qxyi        , Qxyi        , Qxyi        , Qxyi        , Qxyi        , Qxyi        , Qxyi        , Qxyi        , Uyi         , Uyi         , Uyi         , Uyi         , Uyi         , Uyi         , Aa          , Aa          , Aa          , Aa          , Xyui        
Xyui        , Xyui        , Xyui        , Xyui        , Xyui        , Xyui        , Uyi         , Qxyi        , Qxyi        , Qxyi        , Qxyi        , Qxyi        , Qxyi        , Qxyi        , Qxyi        , Qxyi        , Qxyi        , Qxyi        , Qxyi        , Qxyi        , Qxyi        , Uyi         , Uyi         , Uyi         , Uyi         , Uyi         , Uyi         , Aa          , Xyui        , Xyui        
Xyui        , Xyui        , Xyui        , Xyui        , Xyui        , Xyui        , Xyui        , Qxyi        , Qxyi        , Qxyi        , Qxyi        , Qxyi        , Qxyi        , Qxyi        , Qxyi        , Qxyi        , Qxyi        , Qxyi        , Qxyi        , Qxyi        , Qxyi        , Uyi         , Uyi         , Uyi         , Uyi         , Uyi         , Uyi         , Aa          , Xyui        , Xyui        
Xyui        , Xyui        , Xyui        , Xyui        , Xyui        , Xyui        , Xyui        , Qxyi        , Qxyi        , Qxyi        , Uyi         , Qxyi        , Qxyi        , Qxyi        , Qxyi        , Qxyi        , Qxyi        , Qxyi        , Qxyi        , Qxyi        , Uyi         , Uyi         , Xyui        , Uyi         , Xyui        , Uyi         , Aa          , Aa          , Aa          , Xyui        
Xyui        , Xyui        , Xyui        , Xyui        , Xyui        , Xyui        , Xyui        , Xyui        , Uyi         , Uyi         , Uyi         , Uyi         , Uyi         , Uyi         , Uyi         , Qxyi        , Qxyi        , Qxyi        , Uyi         , Uyi         , Xyui        , Xyui        , Xyui        , Xyui        , Xyui        , Xyui        , Xyui        , Xyui        , Xyui        , Xyui        
Xyui        , Xyui        , Xyui        , Xyui        , Xyui        , Aa          , Aa          , Uyi         , Aa          , Aa          , Aa          , Uyi         , Rb          , Uyi         , Uyi         , Uyi         , Uyi         , Uyi         , Xyui        , Xyui        , Xyui        , Xyui        , Xyui        , Xyui        , Xyui        , Xyui        , Xyui        , Xyui        , Xyui        , Xyui        
Xyui        , Xyui        , Xyui        , Xyui        , Aa          , Aa          , Uyi         , Aa          , Ai          , Ai          , Aa          , Aa          , Rb          , Rb          , Uyi         , Uyi         , Xyui        , Xyui        , Xyui        , Xyui        , Xyui        , Xyui        , Xyui        , Xyui        , Xyui        , Xyui        , Xyui        , Xyui        , Xyui        , Xyui        
Xyui        , Xyui        , Aa          , Aa          , Aa          , Uyi         , Uyi         , Aa          , Aa          , Ai          , Aa          , Aa          , Rb          , Rb          , Xyui        , Xyui        , Xyui        , Xyui        , Xyui        , Xyui        , Xyui        , Xyui        , Xyui        , Xyui        , Xyui        , Xyui        , Xyui        , Xyui        , Xyui        , Xyui        
Xyui        , Xyui        , Aa          , Aa          , Aa          , Uyi         , Xyui        , Xyui        , Xyui        , Xyui        , Xyui        , Uyi         , Rb          , Rb          , Uyi         , Xyui        , Ha          , Xyui        , Xyui        , Xyui        , Xyui        , Xyui        , Xyui        , Xyui        , Xyui        , Xyui        , Xyui        , Xyui        , Xyui        , Xyui        
Xyui        , Xyui        , Ai          , Ai          , Aa          , Xyui        , Xyui        , Xyui        , Xyui        , Xyui        , Xyui        , Uyi         , Rb          , Rb          , Uyi         , Uyi         , Ha          , Ha          , Uyi         , Xyui        , Xyui        , Xyui        , Xyui        , Xyui        , Xyui        , Xyui        , Xyui        , Xyui        , Xyui        , Xyui        
Xyui        , Xyui        , Ai          , Ai          , Aa          , Xyui        , Xyui        , Xyui        , Xyui        , Xyui        , Ha          , Ha          , Ha          , Rb          , Uyi         , Ha          , Uyi         , Uyi         , Uyi         , Uyi         , Xyui        , Xyui        , Xyui        , Xyui        , Xyui        , Xyui        , Xyui        , Xyui        , Xyui        , Xyui        
Xyui        , Xyui        , Ai          , Ai          , Aa          , Ha          , Ha          , Uyi         , Uyi         , Ha          , Uyi         , Ha          , Rb          , Rb          , Uyi         , Uyi         , Uyi         , Uyi         , Xyui        , Xyui        , Xyui        , Xyui        , Xyui        , Xyui        , Xyui        , Xyui        , Xyui        , Xyui        , Xyui        , Xyui        
Xyui        , Xyui        , Aa          , Ai          , Aa          , Aa          , Aa          , Uyi         , Ha          , Uyi         , Ha          , Uyi         , Rb          , Uyi         , Uyi         , Uyi         , Xyui        , Xyui        , Xyui        , Xyui        , Xyui        , Xyui        , Xyui        , Xyui        , Xyui        , Xyui        , Xyui        , Xyui        , Xyui        , Xyui        
Xyui        , Xyui        , Xyui        , Aa          , Xyui        , Aa          , Xyui        , Xyui        , Xyui        , Xyui        , Xyui        , Uyi         , Rb          , Uyi         , Ha          , Ha          , Xyui        , Xyui        , Xyui        , Xyui        , Xyui        , Xyui        , Ha          , Uyi         , Uyi         , Ha          , Ha          , Ha          , Xyui        , Xyui        
Xyui        , Xyui        , Xyui        , Xyui        , Xyui        , Xyui        , Xyui        , Xyui        , Xyui        , Xyui        , Xyui        , Aa          , Rb          , Xyui        , Xyui        , Ha          , Xyui        , Xyui        , Xyui        , Xyui        , Xyui        , Ha          , Ha          , Uyi         , Uyi         , Uyi         , Uyi         , Ha          , Xyui        , Xyui        
Xyui        , Xyui        , Xyui        , Xyui        , Xyui        , Xyui        , Qxyi        , Xyui        , Uyi         , Xyui        , Uyi         , Aa          , Uyi         , Rb          , Rb          , Aa          , Uyi         , Xyui        , Uyi         , Xyui        , Uyi         , Xyui        , Uyi         , Uyi         , Uyi         , Uyi         , Uyi         , Uyi         , Xyui        , Xyui        
Xyui        , Xyui        , Xyui        , Xyui        , Uyi         , Uyi         , Uyi         , Qxyi        , Qxyi        , Uyi         , Uyi         , Uyi         , Uyi         , Uyi         , Rb          , Uyi         , Uyi         , Uyi         , Uyi         , Uyi         , Uyi         , Uyi         , Uyi         , Uyi         , Uyi         , Uyi         , Aa          , Aa          , Aa          , Xyui        
Xyui        , Xyui        , Xyui        , Xyui        , Uyi         , Aa          , Aa          , Uyi         , Uyi         , Uyi         , Rb^Cov      , Rb^Cov      , Rb^Cov      , Rb          , Uyi         , Uyi         , Aa          , Aa          , Aa          , Uyi         , Uyi         , Uyi         , Uyi         , Uyi         , Uyi         , Uyi         , Aa          , Aa          , Aa          , Xyui        
Xyui        , Xyui        , Xyui        , Uyi         , Aa          , Aa          , Ha          , Aa          , Ha          , Uyi         , Rb^Cov      , 1 Rb^Kov    , Rb^Cov      , Rb          , Uyi         , Uyi         , Ha          , Aa          , Aa          , Aa          , Aa          , Uyi         , Uyi         , Uyi         , Aa          , Aa          , Aa          , Aa          , Ha          , Xyui        
Xyui        , Xyui        , Xyui        , Uyi         , Uyi         , Aa          , Ha          , Ha          , Ha          , Uyi         , Uyi         , Rb^Cov      , Uyi         , Uyi         , Ha          , Ha          , Ha          , Aa          , Aa          , Aa          , Aa          , Uyi         , Uyi         , Uyi         , Aa          , Aa          , Ha          , Ha          , Xyui        , Xyui        
Xyui        , Xyui        , Xyui        , Xyui        , Xyui        , Ha          , Ha          , Ha          , Uyi         , Uyi         , Uyi         , Uyi         , Uyi         , Ha          , Ha          , Ha          , Uyi         , Uyi         , Uyi         , Aa          , Uyi         , Uyi         , Uyi         , Uyi         , Ha          , Ha          , Xyui        , Xyui        , Xyui        , Xyui        
Xyui        , Xyui        , Xyui        , Xyui        , Xyui        , Xyui        , Xyui        , Uyi         , Xyui        , Xyui        , Xyui        , Xyui        , Xyui        , Uyi         , Uyi         , Uyi         , Xyui        , Uyi         , Uyi         , Uyi         , Uyi         , Uyi         , Ha          , Ha          , Ha          , Ha          , Xyui        , Xyui        , Xyui        , Xyui        
Xyui        , Xyui        , Xyui        , Xyui        , Xyui        , Xyui        , Xyui        , Xyui        , Xyui        , Xyui        , Xyui        , Xyui        , Xyui        , Xyui        , Xyui        , Xyui        , Xyui        , Xyui        , Xyui        , Xyui        , Xyui        , Xyui        , Xyui        , Xyui        , Xyui        , Xyui        , Xyui        , Xyui        , Xyui        , Xyui        
