border_size=1
usage=map

Mm          , Mm          , Hh          , Hh          , Hh          , Hh          , Hh          , Hh          , Mm          , Mm          , Mm          , Mm          , Mm          , Mm          , Mm          , Mm          , Mm          , Hh          , Hh          , Hh          , Hh          , Hh          , Hh          , Hh          , Hh          , Mm          , Mm          , Mm          , Mm          , Mm          
Mm          , Mm          , Hh          , Hh          , Ss          , Hh          , Hh          , Hh          , Hh          , Mm          , Hh          , Mm          , Mm          , Mm          , Hh          , Mm          , Hh          , Hh          , Hh          , Hh          , Ss          , Hh          , Hh          , Hh          , Hh          , Mm          , Mm          , Mm          , Mm          , Mm          
Hh          , Hh          , Hh          , Ss          , Rb          , Ss          , Hh          , Hh          , Hh          , Hh          , Hh          , Hh          , Hh          , Hh          , Hh          , Hh          , Hh          , Hh          , Rb          , Ss          , Ss          , Ss          , Hh          , Hh          , Hh          , Hh          , Hh          , Hh          , Mm          , Mm          
Hh          , Hh          , Hh          , Rb          , Rb          , Ss          , Ss          , Ss          , Ss          , Ss          , Ss          , Hh          , Hh          , Hh          , Ss          , Hh          , Gg          , Gg          , Rb          , Rb          , Ss          , Ss          , Ss          , Ss          , Ss          , Hh          , Hh          , Hh          , Hh          , Mm          
Hh          , Hh          , Ss          , Ss          , Ss          , Hh          , Ss          , Ss          , Ctys        , Ctys        , Ctys        , Rb          , Hh          , Ss          , Ss          , Ss          , Gg          , 2 Gg        , Gg          , Gg          , Hh          , Hh          , Ss          , Gg          , Gg          , Hh          , Hh          , Hh          , Hh          , Hh          
Hh          , Hh          , Ss          , Ss          , Ss          , Hh          , Ss          , Ss          , Ctys        , 3 Ktys      , Ctys        , Rb          , Gg          , Rb          , Rb          , Ss          , Gg          , Gg          , Rb          , Hh          , Ss          , Hh          , Hh          , Gg          , Hh          , Hh          , Hh          , Hh          , Mm          , Hh          
Hh          , Hh          , Hh          , Ss          , Ss          , Ss          , Ss          , Ss          , Rb          , Ctys        , Rb          , Rb          , Gg          , Hh          , Hh          , Hh          , Gg          , Gg          , Gg          , Rb          , Ss          , Ss          , Hh          , Hh          , Hh          , Hh          , Hh          , Mm          , Mm          , Mm          
Hh          , Hh          , Gg          , 4 Gg        , Ss          , Ss          , Ss          , Ss          , Gg          , Rb          , Hh          , Gg          , Gg          , Hh          , Hh          , Hh          , Gg          , Gg          , Gg          , Rb          , Ss          , Ss          , Hh          , Hh          , Hh          , Hh          , Mm          , Mm          , Mm          , Mm          
Hh          , Hh          , Gg          , Gg          , Gg          , Gs^Vht      , Gg          , Gg          , Hh          , Hh          , Hh          , Gg          , Gs^Vht      , Gg          , Hh          , Hh          , Hh          , Gg          , Ss          , Gg          , Ss          , Hh          , Hh          , Hh          , Hh          , Mm          , Mm          , Mm          , Mm          , Mm          
Hh          , Hh          , Gg          , Gg          , Gg          , Gg          , Gg          , Gg          , Hh          , Hh          , Hh          , Gg          , Gg          , Gg          , Hh          , Hh          , Hh          , Ss          , Ss          , Ss          , Ss          , Ss          , Hh          , Hh          , Hh          , Mm          , Mm          , Mm          , Mm          , Mm          
Hh          , Gg          , Gg          , Gg          , Hh          , Gg          , Gg          , Gg          , Ss          , Ss          , Ss          , Hh          , Hh          , Hh          , Hh          , Hh          , Hh          , Ss          , Ss          , Ss          , Ss          , Ss          , Hh          , Hh          , Hh          , Hh          , Hh          , Hh          , Hh          , Hh          
Hh          , Gg          , Gg          , Gg          , Hh          , Hh          , Gg          , Hh          , Gg          , Ss          , Ss          , Hh          , Gg          , Gg          , Hh          , Hh          , Rb          , Rb          , Gg          , Gg          , Ss          , Hh          , Hh          , Hh          , Hh          , Hh          , Hh          , Hh          , Hh          , Hh          
Hh          , Hh          , Gg          , Hh          , Hh          , Gg          , Ss          , Gg          , Gg          , Gg          , Gg          , Gg          , Ss          , Gg          , Ss          , Rb          , Ss          , Ss          , Ss          , Ss          , Ss          , Ss          , Ss          , Gg          , Ss          , Gg          , Hh          , Hh          , Hh          , Hh          
Hh          , Hh          , Gg          , Gg          , Gg          , Gg          , Ss          , Ss          , Ss          , Gg          , Ss          , Ss          , Ss          , Ss          , Ss          , Ss          , Ss          , Ss          , Ss          , Ss          , Gs^Fds      , Ss          , Ss          , Ss          , Ss          , Ss          , Gg          , Hh          , Hh          , Hh          
Hh          , Gg          , Ss          , Ss          , Ss          , Ss          , Gs^Fds      , Gg          , Gg          , Ss          , Ss          , Ss          , Ss          , Ss          , Gg          , Gg          , Gg          , Ss          , Gg          , Gs^Fds      , Gs^Fds      , Gs^Fds      , Ss          , Ss          , Ss          , Ss          , Ss          , Gg          , Hh          , Hh          
Hh          , Ss          , Ss          , Ss          , Ss          , Gs^Fds      , Gs^Fds      , Gg          , Ss          , Ss          , Ss          , Ss          , Gg          , Gg          , Gg          , Gg          , Gg          , Gg          , Gg          , Gg          , Ss          , Ss          , Ss          , Hh          , Hh          , Ss          , Ss          , Gg          , Hh          , Hh          
Hh          , Ss          , Ss          , Ss          , Ss          , Ss          , Ss          , Gs^Fds      , Ss          , Ss          , Ss          , Ss          , Rb          , Gg          , Gg          , Gg          , Gg          , Gg          , Gg          , Gg          , Gg          , Ss          , Ss          , Ss          , Hh          , Hh          , Hh          , Gg          , Hh          , Hh          
Hh          , Ss          , Hh          , Hh          , Gg          , Ss          , Ss          , Ss          , Ss          , Ss          , Ss          , Ss          , Uu          , Rb          , Rb          , Ss          , Ss          , Gg          , Gg          , Gg          , Gg          , Ss          , Ss          , Ss          , Ss          , Hh          , Hh          , Hh          , Hh          , Hh          
Hh          , Hh          , Hh          , Gg          , Gg          , Gg          , Ss          , Ss          , Ss          , Ss          , Ss          , Uu          , Uu          , Uu          , Rb          , Ss          , Ss          , Ss          , Gg          , Gg          , Gg          , Ss          , Ss          , Ss          , Ss          , Ss          , Hh          , Hh          , Hh          , Hh          
Hh          , Hh          , Gg          , Gg          , Gg          , Gg          , Ss          , Ss          , Ss          , Rb          , Rb          , Uu          , Uu          , Uu          , Ss          , Ss          , Gg          , Ss          , Gg          , Gg          , Gg          , Ss          , Ss          , Ss          , Gg          , Ss          , Ss          , Hh          , Hh          , Hh          
Hh          , Hh          , Gg          , Gg          , Gg          , Ss          , Ss          , Ss          , Ss          , Ss          , Ss          , Rb          , Rb          , Rb          , Ss          , Gg          , Gg          , Gg          , Gg          , Gg          , Ss          , Gs^Fds      , Gs^Fds      , Gg          , Gg          , Ss          , Ss          , Gg          , Hh          , Hh          
Hh          , Gg          , Gg          , Gg          , Ss          , Ss          , Gg          , Ss          , Ss          , Ss          , Gg          , Gg          , Gg          , Rb          , Gg          , Gg          , Gg          , Gg          , Gg          , Ss          , Ss          , Gs^Fds      , Gs^Fds      , Gs^Fds      , Gg          , Gg          , Ss          , Ss          , Hh          , Hh          
Hh          , Gg          , Gg          , Gg          , Ss          , Rb          , Gg          , Gg          , Ss          , Ss          , Gg          , Gg          , Gg          , Gg          , Gg          , Gg          , Gg          , Gg          , Gg          , Ss          , Gg          , Ss          , Gs^Fds      , Ss          , Ss          , Ss          , Ss          , Ss          , Hh          , Hh          
Hh          , Gg          , Gg          , Gg          , Gg          , Rb          , Rb          , Gg          , Ss          , Ss          , Gs^Fds      , Gs^Fds      , Gs^Fds      , Gg          , Gg          , Gg          , Gg          , Gg          , Gg          , Gg          , Gg          , Gg          , Ss          , Ss          , Rb          , Ss          , Ss          , Ss          , Gg          , Hh          
Hh          , Gg          , Gg          , Gg          , Gg          , Ss          , Ss          , Ss          , Ss          , Gg          , Gg          , Gs^Fds      , Gg          , Gg          , Gg          , Gg          , Gg          , Gg          , Gg          , Gg          , Gg          , Gg          , Ss          , Rb          , Rb          , Rb          , Ss          , Ss          , Hh          , Hh          
Hh          , Gg          , Gg          , Gg          , Ss          , Ss          , Ss          , Ss          , Gg          , Gg          , Gg          , Gg          , Gg          , Gg          , Rb          , Gg          , Gg          , Gg          , Gs^Vht      , Gg          , Gg          , Gg          , Gg          , Ss          , Ss          , Ss          , Ss          , Ss          , Gg          , Hh          
Hh          , Gg          , Gg          , Gg          , Ss          , Ss          , Ss          , Gg          , Gg          , Gs^Vht      , Gg          , Gg          , Rb          , Rb          , Cty         , Rb          , Rb          , Gg          , Gg          , Gg          , Gg          , Gg          , Gg          , Gg          , Gg          , Ss          , Ss          , Ss          , Ss          , Hh          
Hh          , Gg          , Gg          , Gg          , Ss          , Ss          , Ss          , Gg          , Gg          , Gg          , Gg          , Gg          , Rb          , Cty         , Kty         , Cty         , Rb          , Gg          , Gg          , Gg          , Gg          , Gg          , Gg          , Gg          , Gg          , Gg          , Gg          , Ss          , Ss          , Hh          
Hh          , Hh          , Gg          , Gg          , Gg          , Ss          , Ss          , Gg          , Gg          , Gg          , Gg          , Gg          , Rb          , Cty         , Cty         , Cty         , Rb          , Gg          , Gg          , Ss          , Ss          , Gg          , Gg          , Gg          , Gg          , Gg          , Rb          , Rb          , Ss          , Hh          
Hh          , Gg          , Gg          , Gg          , Gg          , Ss          , Ss          , Gg          , Gg          , Gg          , Gg          , Gg          , Gg          , Rb          , Rb          , Rb          , Gg          , Gg          , Gg          , Ss          , Ss          , Gg          , Gg          , Gg          , Gg          , Gg          , Gg          , Rb          , Ss          , Hh          
Hh          , Gg          , Gg          , Gg          , Ss          , Ss          , Ss          , Gg          , Gg          , Gg          , Gg          , Gg          , Gg          , Gg          , Gg          , Gg          , Gg          , Gg          , Gg          , Ss          , Ss          , Gg          , Gg          , Gg          , Gg          , Gg          , Gg          , Gg          , Ss          , Hh          
Xu          , Hh          , Ss          , Ss          , Ss          , Ss          , Ss          , Ss          , Ss          , Gg          , Gg          , Gg          , Gg          , Gg          , Gg          , Gg          , Gg          , Gg          , Gg          , Gg          , Gg          , Gg          , Gg          , Gg          , Gg          , Gg          , Ss          , Ss          , Hh          , Hh          
Xu          , Xu          , Xu          , Xu          , Xu          , Xu          , Xu          , Xu          , Xu          , Xu          , Xu          , Xu          , Xu          , Gg          , Xu          , Xu          , Xu          , Gg          , Xu          , Gg          , Xu          , Gg          , Gg          , Gg          , Gg          , Gg          , Ss          , Ss          , Xu          , Xu          
Xu          , Xu          , Xu          , Xu          , Xu          , Xu          , Xu          , Xu          , Xu          , Xu          , Xu          , Xu          , Xu          , Xu          , Xu          , Xu          , Xu          , Xu          , Xu          , Xu          , Xu          , Xu          , Xu          , Xu          , Xu          , Xu          , Xu          , Xu          , Xu          , Xu          
Xu          , Xu          , Xyui        , Xu          , Xyui        , Xyui        , Xyui        , Xu          , Xyui        , Xu          , Xyui        , Xu          , Xyui        , Xu          , Xyui        , Xyui        , Xyui        , Xu          , Xyui        , Xu          , Xu          , Xu          , Xu          , Xu          , Xu          , Xu          , Xu          , Xu          , Xu          , Xu          
Xyui        , Xyui        , Xyui        , Xyui        , Xyui        , Xyui        , Xyui        , Xyui        , Xyui        , Xyui        , Xyui        , Xyui        , Qxyi        , Xyui        , Qxyi        , Xyui        , Xyui        , Xyui        , Xyui        , Xyui        , Xyui        , Xyui        , Xyui        , Xyui        , Xyui        , Xyui        , Xyui        , Xyui        , Xyui        , Xu          
Xyui        , Xyui        , Xyui        , Xyui        , Xyui        , Xyui        , Xyui        , Xyui        , Xyui        , Xyui        , Qxyi        , Qxyi        , Qxyi        , Qxyi        , Qxyi        , Qxyi        , Qxyi        , Xyui        , Xyui        , Xyui        , Xyui        , Xyui        , Xyui        , Xyui        , Xyui        , Xyui        , Xyui        , Xyui        , Xyui        , Xyui        
Xyui        , Xyui        , Xyui        , Xyui        , Xyui        , Xyui        , Xyui        , Xyui        , Qxyi        , Qxyi        , Qxyi        , Qxyi        , Qxyi        , Qxyi        , Qxyi        , Qxyi        , Qxyi        , Uyi         , Uyi         , Uyi         , Uyi         , Uyi         , Xyui        , Xyui        , Uyi         , Xyui        , Aa          , Xyui        , Xyui        , Xyui        
Xyui        , Xyui        , Xyui        , Xyui        , Xyui        , Xyui        , Uyi         , Xyui        , Qxyi        , Qxyi        , Qxyi        , Qxyi        , Qxyi        , Qxyi        , Qxyi        , Qxyi        , Qxyi        , Qxyi        , Qxyi        , Uyi         , Uyi         , Uyi         , Uyi         , Uyi         , Uyi         , Aa          , Aa          , Aa          , Aa          , Xyui        
Xyui        , Xyui        , Xyui        , Xyui        , Xyui        , Xyui        , Uyi         , Qxyi        , Qxyi        , Qxyi        , Qxyi        , Qxyi        , Qxyi        , Qxyi        , Qxyi        , Qxyi        , Qxyi        , Qxyi        , Qxyi        , Qxyi        , Qxyi        , Uyi         , Uyi         , Uyi         , Uyi         , Uyi         , Uyi         , Aa          , Xyui        , Xyui        
Xyui        , Xyui        , Xyui        , Xyui        , Xyui        , Xyui        , Xyui        , Qxyi        , Qxyi        , Qxyi        , Qxyi        , Qxyi        , Qxyi        , Qxyi        , Qxyi        , Qxyi        , Qxyi        , Qxyi        , Qxyi        , Qxyi        , Qxyi        , Uyi         , Uyi         , Uyi         , Uyi         , Uyi         , Uyi         , Aa          , Xyui        , Xyui        
Xyui        , Xyui        , Xyui        , Xyui        , Xyui        , Xyui        , Xyui        , Qxyi        , Qxyi        , Qxyi        , Uyi         , Qxyi        , Qxyi        , Qxyi        , Qxyi        , Qxyi        , Qxyi        , Qxyi        , Qxyi        , Qxyi        , Uyi         , Uyi         , Xyui        , Uyi         , Xyui        , Uyi         , Aa          , Aa          , Aa          , Xyui        
Xyui        , Xyui        , Xyui        , Xyui        , Xyui        , Xyui        , Xyui        , Xyui        , Uyi         , Uyi         , Uyi         , Uyi         , Uyi         , Uyi         , Uyi         , Qxyi        , Qxyi        , Qxyi        , Uyi         , Uyi         , Xyui        , Xyui        , Xyui        , Xyui        , Xyui        , Xyui        , Xyui        , Xyui        , Xyui        , Xyui        
Xyui        , Xyui        , Xyui        , Xyui        , Xyui        , Aa          , Aa          , Uyi         , Aa          , Aa          , Aa          , Uyi         , Rb          , Uyi         , Uyi         , Uyi         , Uyi         , Uyi         , Xyui        , Xyui        , Xyui        , Xyui        , Xyui        , Xyui        , Xyui        , Xyui        , Xyui        , Xyui        , Xyui        , Xyui        
Xyui        , Xyui        , Xyui        , Xyui        , Aa          , Aa          , Uyi         , Aa          , Ai          , Ai          , Aa          , Aa          , Rb          , Rb          , Uyi         , Uyi         , Xyui        , Xyui        , Xyui        , Xyui        , Xyui        , Xyui        , Xyui        , Xyui        , Xyui        , Xyui        , Xyui        , Xyui        , Xyui        , Xyui        
Xyui        , Xyui        , Aa          , Aa          , Aa          , Uyi         , Uyi         , Aa          , Aa          , Ai          , Aa          , Aa          , Rb          , Rb          , Xyui        , Xyui        , Xyui        , Xyui        , Xyui        , Xyui        , Xyui        , Xyui        , Xyui        , Xyui        , Xyui        , Xyui        , Xyui        , Xyui        , Xyui        , Xyui        
Xyui        , Xyui        , Aa          , Aa          , Aa          , Uyi         , Xyui        , Xyui        , Xyui        , Xyui        , Xyui        , Uyi         , Rb          , Rb          , Uyi         , Xyui        , Ha          , Xyui        , Xyui        , Xyui        , Xyui        , Xyui        , Xyui        , Xyui        , Xyui        , Xyui        , Xyui        , Xyui        , Xyui        , Xyui        
Xyui        , Xyui        , Ai          , Ai          , Aa          , Xyui        , Xyui        , Xyui        , Xyui        , Xyui        , Xyui        , Uyi         , Rb          , Rb          , Uyi         , Uyi         , Ha          , Ha          , Uyi         , Xyui        , Xyui        , Xyui        , Xyui        , Xyui        , Xyui        , Xyui        , Xyui        , Xyui        , Xyui        , Xyui        
Xyui        , Xyui        , Ai          , Ai          , Aa          , Xyui        , Xyui        , Xyui        , Xyui        , Xyui        , Ha          , Ha          , Ha          , Rb          , Uyi         , Ha          , Uyi         , Uyi         , Uyi         , Uyi         , Xyui        , Xyui        , Xyui        , Xyui        , Xyui        , Xyui        , Xyui        , Xyui        , Xyui        , Xyui        
Xyui        , Xyui        , Ai          , Ai          , Aa          , Ha          , Ha          , Uyi         , Uyi         , Ha          , Uyi         , Ha          , Rb          , Rb          , Uyi         , Uyi         , Uyi         , Uyi         , Xyui        , Xyui        , Xyui        , Xyui        , Xyui        , Xyui        , Xyui        , Xyui        , Xyui        , Xyui        , Xyui        , Xyui        
Xyui        , Xyui        , Aa          , Ai          , Aa          , Aa          , Aa          , Uyi         , Ha          , Uyi         , Ha          , Uyi         , Rb          , Uyi         , Uyi         , Uyi         , Xyui        , Xyui        , Xyui        , Xyui        , Xyui        , Xyui        , Xyui        , Xyui        , Xyui        , Xyui        , Xyui        , Xyui        , Xyui        , Xyui        
Xyui        , Xyui        , Xyui        , Aa          , Xyui        , Aa          , Xyui        , Xyui        , Xyui        , Xyui        , Xyui        , Uyi         , Rb          , Uyi         , Ha          , Ha          , Xyui        , Xyui        , Xyui        , Xyui        , Xyui        , Xyui        , Ha          , Uyi         , Uyi         , Ha          , Ha          , Ha          , Xyui        , Xyui        
Xyui        , Xyui        , Xyui        , Xyui        , Xyui        , Xyui        , Xyui        , Xyui        , Xyui        , Xyui        , Xyui        , Aa          , Rb          , Xyui        , Xyui        , Ha          , Xyui        , Xyui        , Xyui        , Xyui        , Xyui        , Ha          , Ha          , Uyi         , Uyi         , Uyi         , Uyi         , Ha          , Xyui        , Xyui        
Xyui        , Xyui        , Xyui        , Xyui        , Xyui        , Xyui        , Qxyi        , Xyui        , Uyi         , Xyui        , Uyi         , Aa          , Uyi         , Rb          , Rb          , Aa          , Uyi         , Xyui        , Uyi         , Xyui        , Uyi         , Xyui        , Uyi         , Uyi         , Uyi         , Uyi         , Uyi         , Uyi         , Xyui        , Xyui        
Xyui        , Xyui        , Xyui        , Xyui        , Uyi         , Uyi         , Uyi         , Qxyi        , Qxyi        , Uyi         , Uyi         , Uyi         , Uyi         , Uyi         , Rb          , Uyi         , Uyi         , Uyi         , Uyi         , Uyi         , Uyi         , Uyi         , Uyi         , Uyi         , Uyi         , Uyi         , Aa          , Aa          , Aa          , Xyui        
Xyui        , Xyui        , Xyui        , Xyui        , Uyi         , Aa          , Aa          , Uyi         , Uyi         , Uyi         , Rb^Cov      , Rb^Cov      , Rb^Cov      , Rb          , Uyi         , Uyi         , Aa          , Aa          , Aa          , Uyi         , Uyi         , Uyi         , Uyi         , Uyi         , Uyi         , Uyi         , Aa          , Aa          , Aa          , Xyui        
Xyui        , Xyui        , Xyui        , Uyi         , Aa          , Aa          , Ha          , Aa          , Ha          , Uyi         , Rb^Cov      , 1 Rb^Kov    , Rb^Cov      , Rb          , Uyi         , Uyi         , Ha          , Aa          , Aa          , Aa          , Aa          , Uyi         , Uyi         , Uyi         , Aa          , Aa          , Aa          , Aa          , Ha          , Xyui        
Xyui        , Xyui        , Xyui        , Uyi         , Uyi         , Aa          , Ha          , Ha          , Ha          , Uyi         , Uyi         , Rb^Cov      , Uyi         , Uyi         , Ha          , Ha          , Ha          , Aa          , Aa          , Aa          , Aa          , Uyi         , Uyi         , Uyi         , Aa          , Aa          , Ha          , Ha          , Xyui        , Xyui        
Xyui        , Xyui        , Xyui        , Xyui        , Xyui        , Ha          , Ha          , Ha          , Uyi         , Uyi         , Uyi         , Uyi         , Uyi         , Ha          , Ha          , Ha          , Uyi         , Uyi         , Uyi         , Aa          , Uyi         , Uyi         , Uyi         , Uyi         , Ha          , Ha          , Xyui        , Xyui        , Xyui        , Xyui        
Xyui        , Xyui        , Xyui        , Xyui        , Xyui        , Xyui        , Xyui        , Uyi         , Xyui        , Xyui        , Xyui        , Xyui        , Xyui        , Uyi         , Uyi         , Uyi         , Xyui        , Uyi         , Uyi         , Uyi         , Uyi         , Uyi         , Ha          , Ha          , Ha          , Ha          , Xyui        , Xyui        , Xyui        , Xyui        
Xyui        , Xyui        , Xyui        , Xyui        , Xyui        , Xyui        , Xyui        , Xyui        , Xyui        , Xyui        , Xyui        , Xyui        , Xyui        , Xyui        , Xyui        , Xyui        , Xyui        , Xyui        , Xyui        , Xyui        , Xyui        , Xyui        , Xyui        , Xyui        , Xyui        , Xyui        , Xyui        , Xyui        , Xyui        , Xyui        
